SUMLEV,REGION,DIVISION,STATE,COUNTY,STNAME,CTYNAME,ESTIMATESBASE2020,POPESTIMATE2020,POPESTIMATE2021,NPOPCHG2020,NPOPCHG2021,BIRTHS2020,BIRTHS2021,DEATHS2020,DEATHS2021,NATURALCHG2020,NATURALCHG2021,INTERNATIONALMIG2020,INTERNATIONALMIG2021,DOMESTICMIG2020,DOMESTICMIG2021,NETMIG2020,NETMIG2021,RESIDUAL2020,RESIDUAL2021,GQESTIMATESBASE2020,GQESTIMATES2020,GQESTIMATES2021,RBIRTH2021,RDEATH2021,RNATURALCHG2021,RINTERNATIONALMIG2021,RDOMESTICMIG2021,RNETMIG2021
40,3,6,1,0,Alabama,Alabama,5024279,5024803,5039877,524,15074,13410,56320,16148,64868,-2738,-8548,-2,1244,3339,22136,3337,23380,-75,242,114572,114572,114572,11.19161265,12.89022602,-1.698613369,0.247201103,4.398748892,4.645949995
50,3,6,1,1,Alabama,Autauga County,58805,58877,59095,72,218,143,649,168,681,-25,-32,0,5,97,237,97,242,0,8,442,442,442,11.00261079,11.5451124,-0.542501611,0.084765877,4.017902553,4.10266843
50,3,6,1,3,Alabama,Baldwin County,231767,233140,239294,1373,6154,527,2260,661,2867,-134,-607,-1,63,1516,6780,1515,6843,-8,-82,2177,2177,2177,9.567473975,12.13714508,-2.569671107,0.266703921,28.70242193,28.96912585
50,3,6,1,5,Alabama,Barbour County,25223,25180,24964,-43,-216,64,274,109,394,-45,-120,0,1,3,-98,3,-97,-1,1,2789,2789,2789,10.92852585,15.71474154,-4.786215699,0.039885131,-3.908742821,-3.86885769
50,3,6,1,7,Alabama,Bibb County,22293,22223,22477,-70,254,62,226,90,282,-28,-56,0,2,-42,309,-42,311,0,-1,2062,2062,2062,10.11185682,12.61744966,-2.505592841,0.089485459,13.82550336,13.91498881
50,3,6,1,9,Alabama,Blount County,59134,59081,59041,-53,-40,152,629,220,820,-68,-191,0,2,17,140,17,142,-2,9,449,449,449,10.65000593,13.88395049,-3.233944566,0.033863294,2.370430572,2.404293866
50,3,6,1,11,Alabama,Bullock County,10357,10309,10320,-48,11,33,130,37,129,-4,1,0,1,-44,7,-44,8,0,2,1725,1725,1725,12.60361627,12.50666537,0.096950894,0.096950894,0.678656261,0.775607155
50,3,6,1,13,Alabama,Butler County,19051,19045,18884,-6,-161,40,214,58,295,-18,-81,0,3,14,-83,14,-80,-2,0,241,241,241,11.28424161,15.55537979,-4.271138179,0.158190303,-4.376598381,-4.218408078
50,3,6,1,15,Alabama,Calhoun County,116441,116266,115972,-175,-294,311,1320,409,1712,-98,-392,1,4,-74,70,-73,74,-4,24,3251,3251,3251,11.36764871,14.7434959,-3.375847191,0.03444742,0.602829856,0.637277276
50,3,6,1,17,Alabama,Chambers County,34772,34678,34541,-94,-137,85,356,121,512,-36,-156,0,21,-55,-8,-55,13,-3,6,449,449,449,10.2861931,14.79362603,-4.50743293,0.606769818,-0.231150407,0.375619411
50,3,6,1,19,Alabama,Cherokee County,24971,24958,24996,-13,38,55,238,114,473,-59,-235,0,1,49,271,49,272,-3,1,181,181,181,9.528766465,18.93742243,-9.408655963,0.040036834,10.84998198,10.89001882
50,3,6,1,21,Alabama,Chilton County,45014,45024,45274,10,250,125,557,138,590,-13,-33,1,1,24,275,25,276,-2,7,337,337,337,12.33692884,13.06784203,-0.730913199,0.022148885,6.090943321,6.113092206
50,3,6,1,23,Alabama,Choctaw County,12665,12619,12533,-46,-86,36,144,53,218,-17,-74,0,-1,-27,-13,-27,-14,-2,2,107,107,107,11.45038168,17.3346056,-5.884223919,-0.079516539,-1.033715013,-1.113231552
50,3,6,1,25,Alabama,Clarke County,23087,22995,22760,-92,-235,78,287,100,395,-22,-108,0,0,-68,-130,-68,-130,-2,3,189,189,189,12.54507704,17.26587258,-4.720795541,0,-5.682439078,-5.682439078
50,3,6,1,27,Alabama,Clay County,14236,14193,14190,-43,-3,34,141,53,221,-19,-80,0,0,-24,75,-24,75,0,2,252,252,252,9.935524786,15.57270197,-5.637177184,0,5.28485361,5.28485361
50,3,6,1,29,Alabama,Cleburne County,15056,15035,15103,-21,68,31,152,65,252,-34,-100,0,1,14,168,14,169,-1,-1,142,142,142,10.08693344,16.72307386,-6.636140421,0.066361404,11.14871591,11.21507731
50,3,6,1,31,Alabama,Coffee County,53465,53565,54174,100,609,141,663,181,709,-40,-46,0,22,142,633,142,655,-2,0,515,515,515,12.30752095,13.16143643,-0.853915481,0.40839436,11.75061955,12.15901391
50,3,6,1,33,Alabama,Colbert County,57227,57236,57474,9,238,167,578,213,877,-46,-299,0,17,59,516,59,533,-4,4,448,448,448,10.07758696,15.29073315,-5.213146195,0.296399616,8.996600122,9.292999739
50,3,6,1,35,Alabama,Conecuh County,11597,11552,11328,-45,-224,35,137,48,230,-13,-93,0,0,-31,-129,-31,-129,-1,-2,23,23,23,11.97552448,20.10489511,-8.129370629,0,-11.27622378,-11.27622378
50,3,6,1,37,Alabama,Coosa County,10387,10383,10450,-4,67,23,71,32,154,-9,-83,0,0,6,151,6,151,-1,-1,192,192,192,6.816109058,14.78423655,-7.96812749,0,14.49623194,14.49623194
50,3,6,1,39,Alabama,Covington County,37570,37469,37524,-101,55,78,410,176,654,-98,-244,0,1,1,296,1,297,-4,2,517,517,517,10.93435387,17.44162789,-6.507274012,0.026669156,7.894070113,7.920739269
50,3,6,1,41,Alabama,Crenshaw County,13194,13157,13083,-37,-74,25,157,45,218,-20,-61,0,0,-16,-15,-16,-15,-1,2,73,73,73,11.96646342,16.61585366,-4.649390244,0,-1.143292683,-1.143292683
50,3,6,1,43,Alabama,Cullman County,87866,88044,89496,178,1452,245,907,333,1265,-88,-358,0,5,267,1822,267,1827,-1,-17,1019,1019,1019,10.21741579,14.25030979,-4.032893996,0.056325335,20.52495212,20.58127746
50,3,6,1,45,Alabama,Dale County,49326,49214,49342,-112,128,157,637,170,652,-13,-15,-4,18,-94,115,-98,133,-1,10,841,841,841,12.92666099,13.23105646,-0.304395471,0.365274565,2.333698608,2.698973173
50,3,6,1,47,Alabama,Dallas County,38462,38190,37619,-272,-571,112,426,144,567,-32,-141,0,4,-240,-432,-240,-428,0,-2,851,851,851,11.23877112,14.95864607,-3.719874949,0.105528367,-11.39706367,-11.29153531
50,3,6,1,49,Alabama,DeKalb County,71608,71630,71813,22,183,206,752,224,1021,-18,-269,-3,34,46,409,43,443,-3,9,688,688,688,10.48500101,14.23561972,-3.750618713,0.474055897,5.702613582,6.176669479
50,3,6,1,51,Alabama,Elmore County,87977,88116,89304,139,1188,227,906,233,997,-6,-91,0,10,143,1275,143,1285,2,-6,4368,4368,4368,10.21305377,11.23886822,-1.025814452,0.112726863,14.37267501,14.48540187
50,3,6,1,53,Alabama,Escambia County,36757,36665,36699,-92,34,98,429,132,564,-34,-135,0,0,-56,164,-56,164,-2,5,2352,2352,2352,11.69510932,15.37538847,-3.680279156,0,4.470857641,4.470857641
50,3,6,1,55,Alabama,Etowah County,103436,103393,103162,-43,-231,287,1200,406,1751,-119,-551,1,26,81,277,82,303,-6,17,1975,1975,1975,11.61918133,16.95432209,-5.335140762,0.251748929,2.682094357,2.933843286
50,3,6,1,57,Alabama,Fayette County,16321,16307,16148,-14,-159,34,189,57,275,-23,-86,0,1,11,-76,11,-75,-2,2,252,252,252,11.6468957,16.94654137,-5.299645663,0.061623787,-4.683407795,-4.621784009
50,3,6,1,59,Alabama,Franklin County,32113,32063,32013,-50,-50,101,400,114,448,-13,-48,0,32,-37,-41,-37,-9,0,7,239,239,239,12.48517386,13.98339472,-1.498220863,0.998813909,-1.27973032,-0.280916412
50,3,6,1,61,Alabama,Geneva County,26659,26675,26701,16,26,75,259,113,395,-38,-136,0,2,56,160,56,162,-2,0,186,186,186,9.704736211,14.80065947,-5.095923261,0.074940048,5.995203837,6.070143885
50,3,6,1,63,Alabama,Greene County,7730,7704,7629,-26,-75,24,84,24,109,0,-25,0,0,-25,-51,-25,-51,-1,1,22,22,22,10.95675993,14.21770039,-3.260940455,0,-6.652318529,-6.652318529
50,3,6,1,65,Alabama,Hale County,14785,14792,14754,7,-38,46,181,45,250,1,-69,0,1,6,29,6,30,0,1,176,176,176,12.2520815,16.9227645,-4.670683003,0.067691058,1.963040682,2.03073174
50,3,6,1,67,Alabama,Henry County,17146,17167,17459,21,292,42,169,65,247,-23,-78,0,0,45,373,45,373,-1,-3,158,158,158,9.761450933,14.26673598,-4.505285046,0,21.54450413,21.54450413
50,3,6,1,69,Alabama,Houston County,107202,107190,107458,-12,268,284,1291,340,1418,-56,-127,0,16,47,361,47,377,-3,18,1298,1298,1298,12.02899631,13.21232902,-1.183332712,0.149081287,3.363646528,3.512727815
50,3,6,1,71,Alabama,Jackson County,52579,52519,52773,-60,254,142,512,221,823,-79,-311,-1,-2,23,568,22,566,-3,-1,554,554,554,9.725335258,15.63271664,-5.907381378,-0.037989591,10.7890438,10.75105421
50,3,6,1,73,Alabama,Jefferson County,674721,673341,667820,-1380,-5521,1884,8105,2224,8543,-340,-438,-11,153,-1027,-5283,-1038,-5130,-2,47,16732,16732,16732,12.08654293,12.73970836,-0.653165429,0.228160527,-7.878248771,-7.650088244
50,3,6,1,75,Alabama,Lamar County,13972,13943,13689,-29,-254,34,108,60,234,-26,-126,0,0,-1,-129,-1,-129,-2,1,184,184,184,7.817023741,16.93688477,-9.119861031,0,-9.337000579,-9.337000579
50,3,6,1,77,Alabama,Lauderdale County,93564,93610,94043,46,433,220,918,322,1407,-102,-489,0,16,153,906,153,922,-5,0,2299,2299,2299,9.784016243,14.99576346,-5.211747214,0.170527516,9.656120606,9.826648122
50,3,6,1,79,Alabama,Lawrence County,33073,33063,33090,-10,27,88,337,135,511,-47,-174,0,-1,38,199,38,198,-1,3,182,182,182,10.18850241,15.44903481,-5.260532402,-0.030232945,6.016356023,5.986123078
50,3,6,1,81,Alabama,Lee County,174241,174601,177218,360,2617,432,1813,368,1483,64,330,5,123,283,2154,288,2277,8,10,5120,5120,5120,10.30643598,8.43047135,1.87596463,0.69922318,12.24493276,12.94415594
50,3,6,1,83,Alabama,Limestone County,103570,104322,107517,752,3195,230,940,250,1112,-20,-172,-2,22,769,3388,767,3410,5,-43,2705,2705,2705,8.87466425,10.49853899,-1.623874735,0.207704908,31.98655583,32.19426074
50,3,6,1,85,Alabama,Lowndes County,10311,10297,9965,-14,-332,29,138,33,176,-4,-38,0,0,-10,-290,-10,-290,0,-4,92,92,92,13.6215576,17.37242128,-3.750863686,0,-28.62501234,-28.62501234
50,3,6,1,87,Alabama,Macon County,19532,19476,18895,-56,-581,28,159,67,325,-39,-166,0,-3,-16,-406,-16,-409,-1,-6,1694,1694,1694,8.287508796,16.93987647,-8.652367674,-0.15636809,-21.16181491,-21.318183
50,3,6,1,89,Alabama,Madison County,388153,389696,395211,1543,5515,1026,4169,1042,4067,-16,102,3,87,1543,5335,1546,5422,13,-9,8194,8194,8194,10.62291456,10.36301116,0.259903403,0.221682314,13.59396718,13.8156495
50,3,6,1,91,Alabama,Marengo County,19323,19264,18996,-59,-268,48,225,74,306,-26,-81,0,2,-31,-190,-31,-188,-2,1,230,230,230,11.76163095,15.99581809,-4.234187141,0.104547831,-9.93204391,-9.827496079
50,3,6,1,93,Alabama,Marion County,29341,29287,29246,-54,-41,78,322,131,510,-53,-188,0,5,1,139,1,144,-2,3,721,721,721,11.00234056,17.42606735,-6.423726787,0.170843798,4.749457571,4.920301369
50,3,6,1,95,Alabama,Marshall County,97612,97608,98228,-4,620,334,1387,365,1323,-31,64,3,30,25,514,28,544,-1,12,960,960,960,14.1649135,13.51130538,0.653608121,0.306378807,5.249290222,5.555669029
50,3,6,1,97,Alabama,Mobile County,414809,414250,413073,-559,-1177,1239,5081,1434,5460,-195,-379,7,112,-366,-987,-359,-875,-5,77,7156,7156,7156,12.28298984,13.1991979,-0.916208059,0.270752777,-2.38600885,-2.115256073
50,3,6,1,99,Alabama,Monroe County,19772,19723,19648,-49,-75,50,232,67,288,-17,-56,0,0,-30,-22,-30,-22,-2,3,126,126,126,11.78532422,14.63005766,-2.844733433,0,-1.117573849,-1.117573849
50,3,6,1,101,Alabama,Montgomery County,228954,228448,227434,-506,-1014,731,3034,645,2550,86,484,-1,124,-595,-1646,-596,-1522,4,24,8772,8772,8772,13.31046192,11.18710544,2.123356483,0.544000421,-7.221166881,-6.67716646
50,3,6,1,103,Alabama,Morgan County,123421,123336,123668,-85,332,314,1403,443,1620,-129,-217,-1,9,48,526,47,535,-3,14,1960,1960,1960,11.36013992,13.11719648,-1.757056566,0.072873314,4.259040339,4.331913653
50,3,6,1,105,Alabama,Perry County,8511,8452,8355,-59,-97,24,98,34,140,-10,-42,0,0,-49,-55,-49,-55,0,0,643,643,643,11.66180758,16.65972512,-4.997917534,0,-6.544892009,-6.544892009
50,3,6,1,107,Alabama,Pickens County,19123,19062,18801,-61,-261,46,177,88,342,-42,-165,0,4,-19,-102,-19,-98,0,2,1721,1721,1721,9.34949687,18.06512955,-8.715632676,0.211288065,-5.387845654,-5.176557589
50,3,6,1,109,Alabama,Pike County,33009,32981,32991,-28,10,83,365,81,386,2,-21,1,31,-31,-7,-30,24,0,7,1836,1836,1836,11.06530043,11.70193415,-0.636633723,0.939792639,-0.212211241,0.727581398
50,3,6,1,111,Alabama,Randolph County,21967,21971,21989,4,18,55,237,99,340,-44,-103,0,0,48,118,48,118,0,3,278,278,278,10.78252957,15.46860783,-4.686078253,0,5.368516834,5.368516834
50,3,6,1,113,Alabama,Russell County,59183,59226,58722,43,-504,173,826,158,763,15,63,2,14,26,-583,28,-569,0,2,521,521,521,14.00617221,12.93790484,1.068267372,0.237392749,-9.885712348,-9.648319598
50,3,6,1,115,Alabama,St. Clair County,91103,91333,92748,230,1415,231,1003,268,1180,-37,-177,0,13,267,1587,267,1600,0,-8,1429,1429,1429,10.8973767,12.82044317,-1.923066476,0.141242171,17.24240959,17.38365176
50,3,6,1,117,Alabama,Shelby County,223024,223708,226902,684,3194,480,2143,509,2024,-29,119,3,111,710,2970,713,3081,0,-6,2433,2433,2433,9.511551009,8.983378088,0.528172921,0.492665498,13.18213089,13.67479639
50,3,6,1,119,Alabama,Sumter County,12345,12295,12164,-50,-131,29,135,45,188,-16,-53,1,7,-34,-86,-33,-79,-1,1,749,749,749,11.03888139,15.37266446,-4.333783066,0.572386443,-7.032176295,-6.459789852
50,3,6,1,121,Alabama,Talladega County,82149,82069,81524,-80,-545,204,831,292,1249,-88,-418,-1,11,13,-153,12,-142,-4,15,3211,3211,3211,10.1593589,15.269602,-5.110243103,0.134480082,-1.870495681,-1.7360156
50,3,6,1,123,Alabama,Tallapoosa County,41311,41229,41023,-82,-206,97,390,179,709,-82,-319,0,5,4,105,4,110,-4,3,530,530,530,9.483052084,17.23970238,-7.756650294,0.121577591,2.553129407,2.674706998
50,3,6,1,125,Alabama,Tuscaloosa County,227036,227153,227007,117,-146,616,2516,492,2230,124,286,-5,64,-6,-545,-11,-481,4,49,11309,11309,11309,11.07979567,9.820327638,1.259468029,0.281839,-2.40003523,-2.11819623
50,3,6,1,127,Alabama,Walker County,65342,65100,64818,-242,-282,170,782,323,1143,-153,-361,0,11,-85,55,-85,66,-4,13,824,824,824,12.03836266,17.59571422,-5.55735156,0.169337582,0.846687911,1.016025493
50,3,6,1,129,Alabama,Washington County,15388,15296,15147,-92,-149,38,151,68,235,-30,-84,0,1,-61,-70,-61,-69,-1,4,74,74,74,9.920178695,15.4386887,-5.518510002,0.065696548,-4.598758335,-4.533061788
50,3,6,1,131,Alabama,Wilcox County,10600,10518,10446,-82,-72,20,144,56,158,-36,-14,0,3,-45,-62,-45,-59,-1,1,104,104,104,13.73783629,15.07345926,-1.335622973,0.286204923,-5.914901736,-5.628696814
50,3,6,1,133,Alabama,Winston County,23540,23491,23652,-49,161,54,216,84,401,-30,-185,0,-1,-17,351,-17,350,-2,-4,243,243,243,9.163608595,17.01206966,-7.848461065,-0.042424114,14.89086397,14.84843985
40,4,9,2,0,Alaska,Alaska,733391,732441,732673,-950,232,2407,9280,1384,5641,1023,3639,21,526,-2033,-3879,-2012,-3353,39,-54,25840,25840,25840,12.66795621,7.700424677,4.967531537,0.718032863,-5.295151094,-4.577118231
50,4,9,2,13,Alaska,Aleutians East Borough,3420,3418,3398,-2,-20,2,14,4,14,-2,0,0,17,0,-38,0,-21,0,1,1735,1735,1735,4.107981221,4.107981221,0,4.988262911,-11.15023474,-6.161971831
50,4,9,2,16,Alaska,Aleutians West Census Area,5232,5206,5059,-26,-147,9,29,7,14,2,15,0,32,-28,-192,-28,-160,0,-2,2181,2181,2181,5.650267901,2.727715538,2.922552362,6.234778373,-37.40867024,-31.17389187
50,4,9,2,20,Alaska,Anchorage Municipality,291247,290637,288121,-610,-2516,942,3726,561,2179,381,1547,11,296,-1021,-4347,-1010,-4051,19,-12,7791,7791,7791,12.87584794,7.529917513,5.345930423,1.022880029,-15.02182259,-13.99894256
50,4,9,2,50,Alaska,Bethel Census Area,18666,18648,18557,-18,-91,104,408,42,165,62,243,0,3,-81,-335,-81,-332,1,-2,337,337,337,21.93253595,8.869775568,13.06276038,0.161268647,-18.00833221,-17.84706357
50,4,9,2,60,Alaska,Bristol Bay Borough,844,831,838,-13,7,2,8,1,11,1,-3,0,0,-14,10,-14,10,0,0,15,15,15,9.58657879,13.18154584,-3.594967046,0,11.98322349,11.98322349
50,4,9,2,63,Alaska,Chugach Census Area,7102,7073,6941,-29,-132,15,75,9,40,6,35,0,3,-35,-169,-35,-166,0,-1,183,183,183,10.70358213,5.708577137,4.995004995,0.428143285,-24.1187384,-23.69059512
50,4,9,2,66,Alaska,Copper River Census Area,2617,2616,2630,-1,14,4,29,4,29,0,0,0,2,0,11,0,13,-1,1,9,9,9,11.0560427,11.0560427,0,0.762485703,4.193671369,4.956157072
50,4,9,2,68,Alaska,Denali Borough,1619,1611,1593,-8,-18,7,14,2,2,5,12,0,8,-13,-36,-13,-28,0,-2,68,68,68,8.739076155,1.248439451,7.490636704,4.993757803,-22.47191011,-17.47815231
50,4,9,2,70,Alaska,Dillingham Census Area,4857,4839,4772,-18,-67,22,76,10,48,12,28,0,0,-31,-94,-31,-94,1,-1,48,48,48,15.81521174,9.988554781,5.826656956,0,-19.56091978,-19.56091978
50,4,9,2,90,Alaska,Fairbanks North Star Borough,95655,95286,95593,-369,307,352,1276,137,641,215,635,3,16,-595,-352,-592,-336,8,8,4562,4562,4562,13.36972637,6.716296712,6.65342966,0.167645472,-3.688200378,-3.520554907
50,4,9,2,100,Alaska,Haines Borough,2080,2085,2071,5,-14,4,18,6,23,-2,-5,0,0,8,-11,8,-11,-1,2,0,0,0,8.662175168,11.06833494,-2.406159769,0,-5.293551492,-5.293551492
50,4,9,2,105,Alaska,Hoonah-Angoon Census Area,2365,2361,2332,-4,-29,8,17,11,24,-3,-7,0,1,-2,-21,-2,-20,1,-2,0,0,0,7.24483273,10.22799915,-2.983166418,0.426166631,-8.949499254,-8.523332623
50,4,9,2,110,Alaska,Juneau City and Borough,32255,32195,31973,-60,-222,80,275,52,204,28,71,-2,21,-88,-317,-90,-296,2,3,956,956,956,8.571250468,6.358309438,2.21294103,0.654531854,-9.880314175,-9.225782321
50,4,9,2,122,Alaska,Kenai Peninsula Borough,58799,58893,59767,94,874,140,663,125,582,15,81,-1,20,84,777,83,797,-4,-4,1552,1552,1552,11.1747851,9.809539862,1.365245239,0.33709759,13.09624136,13.43333895
50,4,9,2,130,Alaska,Ketchikan Gateway Borough,13948,13902,13754,-46,-148,35,113,26,106,9,7,0,8,-54,-163,-54,-155,-1,0,249,249,249,8.171825282,7.665606017,0.506219265,0.578536303,-11.78767718,-11.20914087
50,4,9,2,150,Alaska,Kodiak Island Borough,13101,13023,12787,-78,-236,29,130,15,78,14,52,2,40,-94,-326,-92,-286,0,-2,366,366,366,10.07361488,6.044168927,4.029445951,3.099573809,-25.26152654,-22.16195273
50,4,9,2,158,Alaska,Kusilvak Census Area,8368,8357,8360,-11,3,58,243,23,84,35,159,1,0,-48,-156,-47,-156,1,0,9,9,9,29.07220195,10.04965006,19.02255189,0,-18.66363582,-18.66363582
50,4,9,2,164,Alaska,Lake and Peninsula Borough,1476,1454,1416,-22,-38,7,21,5,17,2,4,0,1,-23,-43,-23,-42,-1,0,37,37,37,14.63414634,11.8466899,2.787456446,0.696864112,-29.96515679,-29.26829268
50,4,9,2,170,Alaska,Matanuska-Susitna Borough,107081,107460,110686,379,3226,354,1322,209,818,145,504,4,35,225,2716,229,2751,5,-29,1849,1849,1849,12.12032309,7.499564512,4.620758575,0.320886012,24.90075454,25.22164055
50,4,9,2,180,Alaska,Nome Census Area,10046,10032,9865,-14,-167,55,176,22,99,33,77,0,1,-49,-242,-49,-241,2,-3,178,178,178,17.69110921,9.951248932,7.73986028,0.100517666,-24.32527517,-24.2247575
50,4,9,2,185,Alaska,North Slope Borough,11031,10993,10972,-38,-21,42,123,18,58,24,65,0,7,-64,-94,-64,-87,2,1,2584,2584,2584,11.19963578,5.281129069,5.918506715,0.637377646,-8.55907125,-7.921693603
50,4,9,2,188,Alaska,Northwest Arctic Borough,7793,7784,7560,-9,-224,36,150,19,57,17,93,0,1,-27,-313,-27,-312,1,-5,396,396,396,19.55161627,7.429614181,12.12200209,0.130344108,-40.79770594,-40.66736184
50,4,9,2,195,Alaska,Petersburg Borough,3398,3401,3356,3,-45,6,33,3,39,3,-6,0,1,1,-41,1,-40,-1,1,43,43,43,9.767648365,11.54358443,-1.775936066,0.295989344,-12.13556312,-11.83957378
50,4,9,2,198,Alaska,Prince of Wales-Hyder Census Area,5753,5725,5729,-28,4,16,54,26,36,-10,18,0,0,-18,-14,-18,-14,0,0,19,19,19,9.42902043,6.28601362,3.14300681,0,-2.444560852,-2.444560852
50,4,9,2,220,Alaska,Sitka City and Borough,8458,8428,8407,-30,-21,24,85,18,58,6,27,0,4,-37,-52,-37,-48,1,0,241,241,241,10.0980101,6.89040689,3.207603208,0.475200475,-6.177606178,-5.702405702
50,4,9,2,230,Alaska,Skagway Municipality,1240,1239,1132,-1,-107,0,6,0,19,0,-13,0,1,-2,-93,-2,-92,1,-2,32,32,32,5.061155631,16.02699283,-10.9658372,0.843525938,-78.44791227,-77.60438633
50,4,9,2,240,Alaska,Southeast Fairbanks Census Area,6808,6831,6970,23,139,31,101,13,68,18,33,3,8,1,100,4,108,1,-2,325,325,325,14.63662054,9.85435838,4.782262155,1.15933628,14.4917035,15.65103978
50,4,9,2,275,Alaska,Wrangell City and Borough,2127,2130,2055,3,-75,7,19,5,67,2,-48,0,0,1,-27,1,-27,0,0,7,7,7,9.08004779,32.01911589,-22.9390681,0,-12.90322581,-12.90322581
50,4,9,2,282,Alaska,Yakutat City and Borough,662,683,704,21,21,2,4,1,1,1,3,0,0,19,20,19,20,1,-2,19,19,19,5.767844268,1.441961067,4.325883201,0,28.83922134,28.83922134
50,4,9,2,290,Alaska,Yukon-Koyukuk Census Area,5343,5300,5275,-43,-25,14,72,10,60,4,12,0,0,-48,-37,-48,-37,1,0,49,49,49,13.61702128,11.34751773,2.269503546,0,-6.997635934,-6.997635934
40,4,8,4,0,Arizona,Arizona,7151502,7177986,7276316,26484,98330,18036,76497,18340,75665,-304,832,167,4478,26624,93026,26791,97504,-3,-6,145709,145709,145709,10.58466884,10.46954741,0.115121436,0.61960792,12.87173881,13.49134673
50,4,8,4,1,Arizona,Apache County,66021,65897,65623,-124,-274,183,818,262,985,-79,-167,0,4,-46,-123,-46,-119,1,12,669,669,669,12.43917275,14.97871046,-2.539537713,0.060827251,-1.870437956,-1.809610706
50,4,8,4,3,Arizona,Cochise County,125447,125398,126050,-49,652,283,1291,404,1582,-121,-291,7,57,77,875,84,932,-12,11,5063,5063,5063,10.26852471,12.58311858,-2.314593872,0.453374058,6.959689479,7.413063536
50,4,8,4,5,Arizona,Coconino County,145101,145116,145052,15,-64,347,1304,248,1182,99,122,-1,52,-87,-270,-88,-218,4,32,11896,11896,11896,8.987896667,8.147004494,0.840892173,0.358413057,-1.860990874,-1.502577817
50,4,8,4,7,Arizona,Gila County,53272,53306,53589,34,283,111,465,239,969,-128,-504,-1,5,171,788,170,793,-8,-6,682,682,682,8.700126292,18.1299406,-9.429814304,0.093549745,14.74343982,14.83698957
50,4,8,4,9,Arizona,Graham County,38533,38614,39050,81,436,119,466,81,371,38,95,0,19,42,317,42,336,1,5,2692,2692,2692,12.00041203,9.553976102,2.446435929,0.489287186,8.163370416,8.652657602
50,4,8,4,11,Arizona,Greenlee County,9563,9522,9404,-41,-118,26,121,16,54,10,67,0,0,-51,-183,-51,-183,0,-2,35,35,35,12.78664271,5.706435591,7.080207123,0,-19.33847617,-19.33847617
50,4,8,4,12,Arizona,La Paz County,16557,16580,16408,23,-172,36,167,70,392,-34,-225,4,23,58,31,62,54,-5,-1,166,166,166,10.1248939,23.76621802,-13.64132412,1.394446465,1.879471323,3.273917788
50,4,8,4,13,Arizona,Maricopa County,4420568,4438342,4496588,17774,58246,11549,49202,9912,41160,1637,8042,1,3059,15988,46866,15989,49925,148,279,61914,61914,61914,11.01340469,9.213278672,1.800126022,0.684728364,10.49051308,11.17524144
50,4,8,4,15,Arizona,Mohave County,213267,214070,217692,803,3622,406,1671,1030,4021,-624,-2350,-7,-27,1466,6072,1459,6045,-32,-73,3945,3945,3945,7.740375485,18.62600229,-10.8856268,-0.125068904,28.12660679,28.00153788
50,4,8,4,17,Arizona,Navajo County,106717,106802,108147,85,1345,365,1273,415,1482,-50,-209,4,21,135,1535,139,1556,-4,-2,1830,1830,1830,11.84467013,13.78931747,-1.944647335,0.195395187,14.2824577,14.47785289
50,4,8,4,19,Arizona,Pima County,1043433,1045599,1052030,2166,6431,2414,9925,2939,12448,-525,-2523,79,756,2656,8101,2735,8857,-44,97,23601,23601,23601,9.463065204,11.86863835,-2.405573149,0.720813833,7.723958813,8.444772646
50,4,8,4,21,Arizona,Pinal County,425264,429583,449557,4319,19974,1043,4596,1106,4496,-63,100,25,188,4356,19984,4381,20172,1,-298,20718,20718,20718,10.45567259,10.22817754,0.227495052,0.427690698,45.46261119,45.89030189
50,4,8,4,23,Arizona,Santa Cruz County,47669,47653,47883,-16,230,134,563,125,444,9,119,6,64,-29,38,-23,102,-2,9,268,268,268,11.78613298,9.294925473,2.491207503,1.339809077,0.79551164,2.135320717
50,4,8,4,25,Arizona,Yavapai County,236209,237067,242253,858,5186,388,1740,917,3729,-529,-1989,2,-19,1430,7287,1432,7268,-45,-93,3740,3740,3740,7.260285404,15.55954269,-8.299257281,-0.079278979,30.40557456,30.32629559
50,4,8,4,27,Arizona,Yuma County,203881,204437,206990,556,2553,632,2895,576,2350,56,545,48,276,458,1708,506,1984,-6,24,8490,8490,8490,14.07297042,11.42365474,2.649315675,1.341671791,8.30280949,9.644481281
40,3,7,5,0,Arkansas,Arkansas,3011524,3012232,3025891,708,13659,8554,35021,9449,38257,-895,-3236,30,824,1588,16016,1618,16840,-15,55,75792,75792,75792,11.59996244,12.67181871,-1.071856271,0.272932499,5.304959836,5.577892335
50,3,7,5,1,Arkansas,Arkansas County,17149,17105,16722,-44,-383,60,207,76,282,-16,-75,0,1,-27,-306,-27,-305,-1,-3,169,169,169,12.2387442,16.67307181,-4.434327608,0.059124368,-18.09205664,-18.03293227
50,3,7,5,3,Arkansas,Ashley County,19062,18960,18674,-102,-286,55,221,70,305,-15,-84,0,0,-86,-201,-86,-201,-1,-1,124,124,124,11.74469894,16.20874741,-4.464048467,0,-10.68183026,-10.68183026
50,3,7,5,5,Arkansas,Baxter County,41627,41655,42144,28,489,86,315,219,854,-133,-539,0,-4,168,1049,168,1045,-7,-17,483,483,483,7.517989475,20.3821048,-12.86411532,-0.095466533,25.03609828,24.94063175
50,3,7,5,7,Arkansas,Benton County,284333,286353,293692,2020,7339,834,3445,540,2362,294,1083,14,196,1691,6105,1705,6301,21,-45,1813,1813,1813,11.87838875,8.144195709,3.734193037,0.675809636,21.05009094,21.72590058
50,3,7,5,9,Arkansas,Boone County,37373,37352,37830,-21,478,81,375,133,565,-52,-190,0,-2,33,678,33,676,-2,-8,376,376,376,9.975792078,15.0301934,-5.054401319,-0.053204224,18.03623208,17.98302785
50,3,7,5,11,Arkansas,Bradley County,10545,10498,10408,-47,-90,38,146,46,147,-8,-1,0,1,-39,-91,-39,-90,0,1,167,167,167,13.96728212,14.06294844,-0.095666316,0.095666316,-8.705634746,-8.60996843
50,3,7,5,13,Arkansas,Calhoun County,4739,4725,4741,-14,16,12,55,25,75,-13,-20,0,0,0,35,0,35,-1,1,114,114,114,11.62053666,15.84618635,-4.225649694,0,7.394886964,7.394886964
50,3,7,5,15,Arkansas,Carroll County,28260,28202,28435,-58,233,66,295,94,356,-28,-61,-1,14,-25,281,-26,295,-4,-1,178,178,178,10.41721843,12.57128732,-2.154068895,0.494376468,9.922841958,10.41721843
50,3,7,5,17,Arkansas,Chicot County,10208,10143,10019,-65,-124,28,112,43,204,-15,-92,0,0,-49,-33,-49,-33,-1,1,715,715,715,11.11000893,20.23608769,-9.126078762,0,-3.273484773,-3.273484773
50,3,7,5,19,Arkansas,Clark County,21446,21362,21321,-84,-41,47,227,72,301,-25,-74,0,8,-60,23,-60,31,1,2,2733,2733,2733,10.63655319,14.10397582,-3.467422627,0.3748565,1.077712438,1.452568939
50,3,7,5,21,Arkansas,Clay County,14552,14508,14350,-44,-158,31,140,58,241,-27,-101,0,0,-17,-57,-17,-57,0,0,99,99,99,9.702682099,16.70247418,-6.999792085,0,-3.950377712,-3.950377712
50,3,7,5,23,Arkansas,Cleburne County,24711,24665,25015,-46,350,53,211,125,432,-72,-221,0,0,29,581,29,581,-3,-10,266,266,266,8.494363929,17.39130435,-8.896940419,0,23.38969404,23.38969404
50,3,7,5,25,Arkansas,Cleveland County,7550,7544,7514,-6,-30,20,78,38,99,-18,-21,0,0,13,-11,13,-11,-1,2,26,26,26,10.35994156,13.1491566,-2.789215035,0,-1.461017399,-1.461017399
50,3,7,5,27,Arkansas,Columbia County,22801,22741,22672,-60,-69,65,258,89,339,-24,-81,0,2,-37,8,-37,10,1,2,2033,2033,2033,11.36238522,14.9296457,-3.567260476,0.088080506,0.352322022,0.440402528
50,3,7,5,29,Arkansas,Conway County,20715,20729,20873,14,144,66,185,80,296,-14,-111,1,7,28,248,29,255,-1,0,215,215,215,8.893803183,14.23008509,-5.33628191,0.336522283,11.92250373,12.25902601
50,3,7,5,31,Arkansas,Craighead County,111231,111576,112218,345,642,354,1356,254,1224,100,132,0,28,238,465,238,493,7,17,3734,3734,3734,12.11828735,10.93863106,1.179656291,0.250230122,4.155607389,4.405837511
50,3,7,5,33,Arkansas,Crawford County,60133,60107,60378,-26,271,178,706,198,774,-20,-68,0,16,-6,313,-6,329,0,10,381,381,381,11.71930116,12.84807237,-1.128771216,0.265593227,5.195667511,5.461260738
50,3,7,5,35,Arkansas,Crittenden County,48163,48067,47525,-96,-542,164,657,162,643,2,14,0,8,-99,-565,-99,-557,1,1,921,921,921,13.74592016,13.45300862,0.292911541,0.167378023,-11.82107289,-11.65369487
50,3,7,5,37,Arkansas,Cross County,16833,16762,16681,-71,-81,37,210,63,260,-26,-50,0,1,-44,-34,-44,-33,-1,2,213,213,213,12.55868194,15.5488443,-2.990162366,0.059803247,-2.033310409,-1.973507161
50,3,7,5,39,Arkansas,Dallas County,6482,6445,6308,-37,-137,9,45,17,110,-8,-65,-1,0,-27,-73,-28,-73,-1,1,291,291,291,7.057163021,17.25084294,-10.19367992,0,-11.44828668,-11.44828668
50,3,7,5,41,Arkansas,Desha County,11395,11330,11090,-65,-240,37,127,35,158,2,-31,0,7,-68,-213,-68,-206,1,-3,48,48,48,11.32917038,14.09455843,-2.765388046,0.624442462,-19.00089206,-18.3764496
50,3,7,5,43,Arkansas,Drew County,17350,17309,17110,-41,-199,42,210,46,239,-4,-29,0,0,-36,-171,-36,-171,-1,1,615,615,615,12.20256254,13.88767832,-1.685115779,0,-9.936372352,-9.936372352
50,3,7,5,45,Arkansas,Faulkner County,123498,123666,125106,168,1440,329,1451,304,1284,25,167,1,62,137,1200,138,1262,5,11,3706,3706,3706,11.66529995,10.32270513,1.342594826,0.498448378,9.64738797,10.14583635
50,3,7,5,47,Arkansas,Franklin County,17097,17122,17173,25,51,55,205,75,263,-20,-58,0,-1,46,108,46,107,-1,2,344,344,344,11.9550955,15.33751276,-3.382417262,-0.058317539,6.298294212,6.239976673
50,3,7,5,49,Arkansas,Fulton County,12075,12033,12145,-42,112,26,131,58,236,-32,-105,0,3,-7,217,-7,220,-3,-3,113,113,113,10.83629746,19.52187939,-8.685581934,0.248159484,17.95020266,18.19836215
50,3,7,5,51,Arkansas,Garland County,100180,100162,100330,-18,168,252,1030,437,1657,-185,-627,0,29,178,762,178,791,-11,4,2036,2036,2036,10.27472418,16.52933783,-6.25461365,0.289288351,7.6013008,7.890589151
50,3,7,5,53,Arkansas,Grant County,17958,17975,18090,17,115,44,186,72,248,-28,-62,0,0,45,178,45,178,0,-1,92,92,92,10.31470955,13.75294607,-3.438236517,0,9.871066131,9.871066131
50,3,7,5,55,Arkansas,Greene County,45736,45818,46317,82,499,142,563,133,605,9,-42,0,1,73,542,73,543,0,-2,532,532,532,12.22119716,13.13290281,-0.911705649,0.021707277,11.76534433,11.78705161
50,3,7,5,57,Arkansas,Hempstead County,20065,19993,19694,-72,-299,69,286,60,291,9,-5,0,-2,-81,-290,-81,-292,0,-2,145,145,145,14.41278,14.66475168,-0.251971678,-0.100788671,-14.61435735,-14.71514602
50,3,7,5,59,Arkansas,Hot Spring County,33040,33034,33148,-6,114,67,327,121,488,-54,-161,0,4,49,267,49,271,-1,4,2023,2023,2023,9.881840984,14.74721223,-4.865371249,0.120878789,8.068659152,8.189537941
50,3,7,5,61,Arkansas,Howard County,12785,12755,12698,-30,-57,46,174,49,191,-3,-17,-1,0,-26,-42,-27,-42,0,2,127,127,127,13.67225867,15.00805406,-1.335795388,0,-3.300200369,-3.300200369
50,3,7,5,63,Arkansas,Independence County,37938,37892,37723,-46,-169,102,430,136,485,-34,-55,0,8,-11,-127,-11,-119,-1,5,883,883,883,11.37340475,12.82814256,-1.454737817,0.211598228,-3.359121867,-3.147523639
50,3,7,5,65,Arkansas,Izard County,13577,13576,13911,-1,335,33,135,69,224,-36,-89,0,0,37,430,37,430,-2,-6,903,903,903,9.822825336,16.29861389,-6.475788555,0,31.28751774,31.28751774
50,3,7,5,67,Arkansas,Jackson County,16755,16737,16811,-18,74,48,174,70,242,-22,-68,0,0,5,141,5,141,-1,1,2057,2057,2057,10.37319661,14.42708954,-4.05389293,0,8.405866222,8.405866222
50,3,7,5,69,Arkansas,Jefferson County,67260,66811,65861,-449,-950,169,757,224,944,-55,-187,0,32,-394,-794,-394,-762,0,-1,5368,5368,5368,11.41160154,14.2305837,-2.818982151,0.482392668,-11.96936807,-11.4869754
50,3,7,5,71,Arkansas,Johnson County,25749,25692,25845,-57,153,64,291,81,326,-17,-35,0,-2,-40,187,-40,185,0,3,519,519,519,11.29285756,12.65110503,-1.358247473,-0.077614141,7.256922211,7.17930807
50,3,7,5,73,Arkansas,Lafayette County,6308,6294,6163,-14,-131,16,77,26,121,-10,-44,0,4,-2,-91,-2,-87,-2,0,36,36,36,12.36252709,19.42682829,-7.064301196,0.6422092,-14.61025929,-13.96805009
50,3,7,5,75,Arkansas,Lawrence County,16216,16196,16292,-20,96,42,174,77,268,-35,-94,0,3,15,189,15,192,0,-2,609,609,609,10.71164738,16.49839941,-5.786752032,0.184683576,11.63506526,11.81974883
50,3,7,5,77,Arkansas,Lee County,8600,8529,8619,-71,90,28,97,40,126,-12,-29,0,9,-59,111,-59,120,0,-1,1585,1585,1585,11.31327269,14.69559132,-3.382318638,1.049685095,12.94611617,13.99580126
50,3,7,5,79,Arkansas,Lincoln County,12941,12879,13037,-62,158,21,85,54,158,-33,-73,0,9,-28,223,-28,232,-1,-1,3462,3462,3462,6.559654268,12.1932397,-5.63358543,0.694551628,17.2094459,17.90399753
50,3,7,5,81,Arkansas,Little River County,12026,11971,11944,-55,-27,33,147,48,224,-15,-77,0,0,-39,49,-39,49,-1,1,81,81,81,12.29353962,18.73301275,-6.439473134,0,4.09784654,4.09784654
50,3,7,5,83,Arkansas,Logan County,21131,21097,21215,-34,118,57,235,86,343,-29,-108,0,1,-4,225,-4,226,-1,0,483,483,483,11.10795992,16.21289469,-5.10493477,0.047267915,10.63528077,10.68254869
50,3,7,5,85,Arkansas,Lonoke County,74015,74042,74722,27,680,227,867,232,839,-5,28,0,9,29,636,29,645,3,7,484,484,484,11.65604582,11.27961066,0.376435159,0.120997015,8.550455755,8.671452771
50,3,7,5,87,Arkansas,Madison County,16521,16551,16960,30,409,50,219,39,204,11,15,0,5,20,394,20,399,-1,-5,58,58,58,13.07033511,12.17510668,0.895228433,0.298409478,23.51466683,23.8130763
50,3,7,5,89,Arkansas,Marion County,16826,16862,16978,36,116,26,147,65,313,-39,-166,0,1,76,285,76,286,-1,-4,110,110,110,8.687943262,18.49881797,-9.810874704,0.059101655,16.84397163,16.90307329
50,3,7,5,91,Arkansas,Miller County,42600,42570,42649,-30,79,121,516,130,584,-9,-68,0,-6,-21,147,-21,141,0,6,1153,1153,1153,12.10997548,13.70586372,-1.595888241,-0.140813668,3.449934874,3.309121205
50,3,7,5,93,Arkansas,Mississippi County,40685,40503,39661,-182,-842,130,593,148,599,-18,-6,0,7,-166,-835,-166,-828,2,-8,696,696,696,14.79467093,14.94436405,-0.149693129,0.174641984,-20.8322938,-20.65765181
50,3,7,5,95,Arkansas,Monroe County,6799,6765,6683,-34,-82,12,87,15,122,-3,-35,0,0,-31,-48,-31,-48,0,1,80,80,80,12.93872695,18.14396193,-5.205234979,0,-7.138607971,-7.138607971
50,3,7,5,97,Arkansas,Montgomery County,8484,8459,8611,-25,152,15,85,46,165,-31,-80,0,-1,7,236,7,235,-1,-3,74,74,74,9.958992384,19.33216169,-9.373169303,-0.117164616,27.65084944,27.53368483
50,3,7,5,99,Arkansas,Nevada County,8310,8284,8187,-26,-97,21,76,29,126,-8,-50,0,-2,-17,-44,-17,-46,-1,-1,146,146,146,9.22834072,15.29961751,-6.07127679,-0.242851072,-5.342723575,-5.585574646
50,3,7,5,101,Arkansas,Newton County,7225,7198,7204,-27,6,14,68,25,113,-11,-45,0,0,-15,51,-15,51,-1,0,29,29,29,9.443132898,15.69226496,-6.249132065,0,7.082349674,7.082349674
50,3,7,5,103,Arkansas,Ouachita County,22650,22592,22306,-58,-286,65,248,97,405,-32,-157,0,1,-24,-132,-24,-131,-2,2,238,238,238,11.04726268,18.04089269,-6.993630006,0.044545414,-5.879994655,-5.835449241
50,3,7,5,105,Arkansas,Perry County,10019,9997,9964,-22,-33,30,92,42,162,-12,-70,0,0,-10,37,-10,37,0,0,88,88,88,9.217975051,16.23165172,-7.01367667,0,3.707229097,3.707229097
50,3,7,5,107,Arkansas,Phillips County,16568,16445,15906,-123,-539,58,263,77,279,-19,-16,0,0,-104,-514,-104,-514,0,-9,130,130,130,16.25915737,17.24830763,-0.989150258,0,-31.77645204,-31.77645204
50,3,7,5,109,Arkansas,Pike County,10171,10165,10066,-6,-99,24,87,23,177,1,-90,0,0,-7,-9,-7,-9,0,0,124,124,124,8.60066235,17.49789926,-8.897236914,0,-0.889723691,-0.889723691
50,3,7,5,111,Arkansas,Poinsett County,22965,22893,22660,-72,-233,74,277,112,412,-38,-135,0,6,-33,-108,-33,-102,-1,4,257,257,257,12.16165785,18.08881962,-5.927161768,0.263429412,-4.741729414,-4.478300002
50,3,7,5,113,Arkansas,Polk County,19221,19182,19353,-39,171,64,232,72,341,-8,-109,0,0,-28,280,-28,280,-3,0,96,96,96,12.04100169,17.69819645,-5.657194758,0,14.53224342,14.53224342
50,3,7,5,115,Arkansas,Pope County,63381,63346,63789,-35,443,164,631,210,728,-46,-97,2,-2,9,539,11,537,0,3,3169,3169,3169,9.926456129,11.45239313,-1.525936996,-0.031462618,8.479175679,8.447713061
50,3,7,5,117,Arkansas,Prairie County,8282,8248,8135,-34,-113,21,93,33,129,-12,-36,0,0,-22,-76,-22,-76,0,-1,126,126,126,11.35323201,15.7480315,-4.394799487,0,-9.277910029,-9.277910029
50,3,7,5,119,Arkansas,Pulaski County,399125,399073,397821,-52,-1252,1239,4948,1165,4632,74,316,8,118,-132,-1743,-124,-1625,-2,57,8467,8467,8467,12.41821372,11.62513459,0.79307913,0.296149802,-4.374483934,-4.078334132
50,3,7,5,121,Arkansas,Randolph County,18571,18581,18865,10,284,55,266,65,286,-10,-20,1,11,20,297,21,308,-1,-4,320,320,320,14.20712493,15.27532981,-1.068204882,0.587512685,15.86284249,16.45035518
50,3,7,5,123,Arkansas,St. Francis County,23090,23046,22739,-44,-307,95,309,77,302,18,7,0,7,-63,-318,-63,-311,1,-3,3721,3721,3721,13.49787048,13.19209348,0.305777001,0.305777001,-13.89101234,-13.58523534
50,3,7,5,125,Arkansas,Saline County,123416,123681,125233,265,1552,310,1321,353,1430,-43,-109,1,18,310,1646,311,1664,-3,-3,1276,1276,1276,10.61410768,11.48991218,-0.875804495,0.144628265,13.22545136,13.37007963
50,3,7,5,127,Arkansas,Scott County,9836,9811,9822,-25,11,32,118,48,128,-16,-10,0,0,-9,21,-9,21,0,0,49,49,49,12.0205776,13.03927062,-1.018693017,0,2.139255335,2.139255335
50,3,7,5,129,Arkansas,Searcy County,7828,7827,7880,-1,53,19,77,28,141,-9,-64,0,1,8,118,8,119,0,-2,49,49,49,9.804545744,17.95377857,-8.149232826,0.127331763,15.02514802,15.15247979
50,3,7,5,131,Arkansas,Sebastian County,127799,127739,128400,-60,661,399,1612,376,1542,23,70,-1,24,-81,546,-82,570,-1,21,1999,1999,1999,12.5869157,12.04033747,0.546578225,0.187398249,4.263310156,4.450708404
50,3,7,5,133,Arkansas,Sevier County,15839,15778,15783,-61,5,57,263,43,187,14,76,1,0,-77,-72,-76,-72,1,1,99,99,99,16.66613859,11.85006812,4.816070467,0,-4.562593074,-4.562593074
50,3,7,5,135,Arkansas,Sharp County,17271,17282,17622,11,340,42,175,85,335,-43,-160,0,1,55,509,55,510,-1,-10,142,142,142,10.02750401,19.19550768,-9.168003667,0.057300023,29.16571167,29.22301169
50,3,7,5,137,Arkansas,Stone County,12359,12364,12481,5,117,29,114,49,191,-20,-77,0,0,26,196,26,196,-1,-2,99,99,99,9.17689676,15.37532703,-6.198430268,0,15.7778225,15.7778225
50,3,7,5,139,Arkansas,Union County,39054,38925,38340,-129,-585,100,423,143,612,-43,-189,-1,-5,-83,-390,-84,-395,-2,-1,476,476,476,10.94933023,15.84158416,-4.892253931,-0.129424707,-10.09512716,-10.22455187
50,3,7,5,141,Arkansas,Van Buren County,15796,15765,15694,-31,-71,22,105,79,279,-57,-174,0,5,28,97,28,102,-2,1,128,128,128,6.675355224,17.73737245,-11.06201723,0.317874058,6.166756731,6.484630789
50,3,7,5,143,Arkansas,Washington County,245871,246662,250057,791,3395,774,3029,517,2089,257,940,5,170,511,2253,516,2423,18,32,7966,7966,7966,12.19603035,8.411194257,3.784836095,0.684491634,9.071527363,9.756018997
50,3,7,5,145,Arkansas,White County,76822,76810,77207,-12,397,182,832,221,1020,-39,-188,0,8,27,572,27,580,0,5,2822,2822,2822,10.80400216,13.2452911,-2.441288949,0.103884636,7.427751482,7.531636118
50,3,7,5,147,Arkansas,Woodruff County,6269,6200,6116,-69,-84,7,66,37,122,-30,-56,0,0,-38,-29,-38,-29,-1,1,82,82,82,10.71776551,19.81162715,-9.093861643,0,-4.709321208,-4.709321208
50,3,7,5,149,Arkansas,Yell County,20263,20216,20155,-47,-61,70,246,65,273,5,-27,1,5,-51,-42,-50,-37,-2,3,221,221,221,12.18696589,13.52455971,-1.337593817,0.247702559,-2.080701494,-1.832998935
40,4,9,6,0,California,California,39538223,39499738,39237836,-38485,-261902,104957,424333,81738,332337,23219,91996,-478,14339,-62084,-367299,-62562,-352960,858,-938,815696,815696,815696,10.77841184,8.441636772,2.33677507,0.36422255,-9.329700709,-8.965478159
50,4,9,6,1,California,Alameda County,1682353,1679844,1648556,-2509,-31288,4449,17349,2827,12705,1622,4644,37,2262,-4211,-37804,-4174,-35542,43,-390,36392,36392,36392,10.42482875,7.634298762,2.790529984,1.359211633,-22.71601971,-21.35680808
50,4,9,6,3,California,Alpine County,1204,1198,1235,-6,37,2,9,10,15,-8,-6,0,0,2,43,2,43,0,0,24,24,24,7.398273736,12.33045623,-4.932182491,0,35.34730785,35.34730785
50,4,9,6,5,California,Amador County,40474,40541,41259,67,718,67,287,133,521,-66,-234,1,3,138,963,139,966,-6,-14,4415,4415,4415,7.017114914,12.73838631,-5.721271394,0.073349633,23.54523227,23.61858191
50,4,9,6,7,California,Butte County,211632,210083,208309,-1549,-1774,504,2022,607,2383,-103,-361,2,14,-1451,-1453,-1449,-1439,3,26,5112,5112,5112,9.66557678,11.39123119,-1.72565441,0.066922886,-6.945639496,-6.87871661
50,4,9,6,9,California,Calaveras County,45292,45327,46221,35,894,86,379,136,603,-50,-224,-1,5,93,1133,92,1138,-7,-20,384,384,384,8.279809499,13.17341722,-4.893607725,0.109232315,24.75204264,24.86127496
50,4,9,6,11,California,Colusa County,21839,21853,21917,14,64,65,264,47,150,18,114,0,-11,-4,-44,-4,-55,0,5,230,230,230,12.06305689,6.854009596,5.209047293,-0.50262737,-2.010509481,-2.513136852
50,4,9,6,13,California,Contra Costa County,1165927,1165562,1161413,-365,-4149,2911,11600,2242,9804,669,1796,107,806,-1142,-6917,-1035,-6111,1,166,9880,9880,9880,9.970025462,8.426390486,1.543634977,0.692744873,-5.945057424,-5.252312552
50,4,9,6,15,California,Del Norte County,27743,27709,28100,-34,391,47,258,94,298,-47,-40,2,5,12,429,14,434,-1,-3,2996,2996,2996,9.245820567,10.67928112,-1.433460553,0.179182569,15.37386443,15.553047
50,4,9,6,17,California,El Dorado County,191185,191114,193221,-71,2107,374,1471,456,2051,-82,-580,-1,52,30,2664,29,2716,-18,-29,1451,1451,1451,7.654780335,10.6729806,-3.018200268,0.270597265,13.86290606,14.13350332
50,4,9,6,19,California,Fresno County,1008654,1008966,1013581,312,4615,3428,13817,2277,8865,1151,4952,-35,9,-856,-617,-891,-608,52,271,17384,17384,17384,13.6629705,8.766174531,4.896795971,0.00889967,-0.610121792,-0.601222122
50,4,9,6,21,California,Glenn County,28917,28893,28805,-24,-88,97,361,55,260,42,101,0,-3,-67,-191,-67,-194,1,5,292,292,292,12.51343201,9.012444106,3.500987903,-0.10398974,-6.620680093,-6.724669833
50,4,9,6,23,California,Humboldt County,136463,136351,136310,-112,-41,368,1290,347,1536,21,-246,-1,11,-126,174,-127,185,-6,20,5182,5182,5182,9.462299339,11.26673782,-1.804438479,0.080686273,1.276310143,1.356996417
50,4,9,6,25,California,Imperial County,179702,179489,179851,-213,362,562,2289,467,1567,95,722,12,-60,-330,-344,-318,-404,10,44,8296,8296,8296,12.74002338,8.721545055,4.018478321,-0.333945567,-1.91462125,-2.248566817
50,4,9,6,27,California,Inyo County,19016,19023,18970,7,-53,48,172,57,201,-9,-29,0,0,18,-26,18,-26,-2,2,403,403,403,9.054299476,10.58089648,-1.526597005,0,-1.368673177,-1.368673177
50,4,9,6,29,California,Kern County,909235,909997,917673,762,7676,3014,12371,2014,7682,1000,4689,-46,-184,-253,2989,-299,2805,61,182,30494,30494,30494,13.53745479,8.406331559,5.131123233,-0.201349259,3.270831168,3.069481909
50,4,9,6,31,California,Kings County,152486,152627,153443,141,816,542,2176,262,1083,280,1093,-3,-71,-147,-245,-150,-316,11,39,15702,15702,15702,14.21896952,7.076812494,7.142157023,-0.463946156,-1.600940961,-2.064887117
50,4,9,6,33,California,Lake County,68163,68174,68766,11,592,180,723,226,884,-46,-161,-1,-2,66,763,65,761,-8,-8,1091,1091,1091,10.55936907,12.91076384,-2.351394771,-0.029209873,11.14356653,11.11435665
50,4,9,6,35,California,Lassen County,32730,32719,33159,-11,440,92,292,63,242,29,50,0,1,-39,389,-39,390,-1,0,7605,7605,7605,8.864871429,7.346913993,1.517957437,0.030359149,11.80970886,11.840068
50,4,9,6,37,California,Los Angeles County,10014009,9989165,9829544,-24844,-159621,24177,99716,20782,82350,3395,17366,-443,4023,-28160,-179757,-28603,-175734,364,-1253,178739,178739,178739,10.06281489,8.310329396,1.752485492,0.405980026,-18.14013213,-17.73415211
50,4,9,6,39,California,Madera County,156255,156620,159410,365,2790,534,2069,336,1302,198,767,-2,-94,165,2127,163,2033,4,-10,6862,6862,6862,13.09369364,8.239724077,4.85396956,-0.594880233,13.4607474,12.86586717
50,4,9,6,41,California,Marin County,262321,261776,260206,-545,-1570,532,2034,549,2305,-17,-271,3,164,-507,-1490,-504,-1326,-24,27,8396,8396,8396,7.793372185,8.831722167,-1.038349981,0.628374159,-5.709009123,-5.080634964
50,4,9,6,43,California,Mariposa County,17131,17124,17147,-7,23,22,129,50,197,-28,-68,0,3,23,91,23,94,-2,-3,688,688,688,7.528230866,11.49660062,-3.968369759,0.175075136,5.310612471,5.485687608
50,4,9,6,45,California,Mendocino County,91601,91354,91305,-247,-49,204,869,243,1037,-39,-168,-1,8,-198,102,-199,110,-9,9,1976,1976,1976,9.514997892,11.35449116,-1.839493263,0.087594917,1.116835196,1.204430113
50,4,9,6,47,California,Merced County,281202,281726,286461,524,4735,976,3737,588,2224,388,1513,0,-85,119,3305,119,3220,17,2,6763,6763,6763,13.15412003,7.828408605,5.32571143,-0.299197271,11.6334939,11.33429663
50,4,9,6,49,California,Modoc County,8700,8658,8661,-42,3,4,50,34,114,-30,-64,0,-2,-10,70,-10,68,-2,-1,282,282,282,5.774005428,13.16473238,-7.390726947,-0.230960217,8.083607599,7.852647382
50,4,9,6,51,California,Mono County,13195,13206,13247,11,41,26,111,12,49,14,62,2,25,-6,-47,-4,-22,1,1,244,244,244,8.392242846,3.704683779,4.687559067,1.890144785,-3.553472196,-1.663327411
50,4,9,6,53,California,Monterey County,439035,438500,437325,-535,-1175,1436,5595,770,3128,666,2467,-46,-120,-1172,-3563,-1218,-3683,17,41,17194,17194,17194,12.77652499,7.142979477,5.633545514,-0.274027346,-8.136328604,-8.41035595
50,4,9,6,55,California,Napa County,138019,137608,136207,-411,-1401,289,1214,307,1399,-18,-185,-2,-26,-386,-1196,-388,-1222,-5,6,4960,4960,4960,8.867300915,10.21857824,-1.351277322,-0.189909245,-8.735825283,-8.925734529
50,4,9,6,57,California,Nevada County,102241,102199,103487,-42,1288,203,783,297,1135,-94,-352,0,-4,67,1670,67,1666,-15,-26,1129,1129,1129,7.613546863,11.03623971,-3.422692842,-0.038894237,16.23834388,16.19944965
50,4,9,6,59,California,Orange County,3186989,3184101,3167809,-2888,-16292,7723,32347,5980,25108,1743,7239,-86,1214,-4590,-25019,-4676,-23805,45,274,42899,42899,42899,10.18496799,7.905653575,2.279314411,0.38224723,-7.877630508,-7.495383278
50,4,9,6,61,California,Placer County,404739,405741,412300,1002,6559,913,3510,914,3915,-1,-405,1,43,1027,6984,1028,7027,-25,-63,3718,3718,3718,8.581476968,9.571647387,-0.990170419,0.105129205,17.07493879,17.18006799
50,4,9,6,63,California,Plumas County,19790,19769,19915,-21,146,31,155,43,248,-12,-93,0,3,-5,239,-5,242,-4,-3,275,275,275,7.811712529,12.49874005,-4.687027517,0.151194436,12.04515674,12.19635117
50,4,9,6,65,California,Riverside County,2418185,2422764,2458395,4579,35631,6646,27110,5593,22167,1053,4943,-38,-508,3520,31251,3482,30743,44,-55,32333,32333,32333,11.10801758,9.082678929,2.025338654,-0.208147286,12.80474576,12.59659847
50,4,9,6,67,California,Sacramento County,1585055,1586241,1588921,1186,2680,4548,18263,3453,14293,1095,3970,113,989,-50,-2639,63,-1650,28,360,23065,23065,23065,11.50366501,9.003005201,2.500659809,0.62296034,-1.662277389,-1.039317049
50,4,9,6,69,California,San Benito County,64209,64507,66677,298,2170,195,766,124,397,71,369,0,-43,224,1869,224,1826,3,-25,326,326,326,11.67825345,6.052567386,5.625686059,-0.655567752,28.49432858,27.83876082
50,4,9,6,71,California,San Bernardino County,2181654,2182740,2194710,1086,11970,6455,27178,5120,18941,1335,8237,-46,-365,-322,3608,-368,3243,119,490,37626,37626,37626,12.4172749,8.653896675,3.763378223,-0.166763755,1.648448298,1.481684542
50,4,9,6,73,California,San Diego County,3298634,3297252,3286069,-1382,-11183,9284,37107,6314,26463,2970,10644,-112,718,-4293,-22867,-4405,-22149,53,322,107528,107528,107528,11.27303378,8.039407466,3.233626311,0.218126991,-6.946949723,-6.728822732
50,4,9,6,75,California,San Francisco County,873965,870014,815201,-3951,-54813,2032,7944,1648,7135,384,809,49,957,-4400,-55631,-4351,-54674,16,-948,25395,25395,25395,9.427877155,8.467762274,0.960114882,1.135760126,-66.02243631,-64.88667618
50,4,9,6,77,California,San Joaquin County,779233,780517,789410,1284,8893,2536,9682,1880,7059,656,2623,-2,148,601,6051,599,6199,29,71,15767,15767,15767,12.33433147,8.992774823,3.341556646,0.188543799,7.708638682,7.897182481
50,4,9,6,79,California,San Luis Obispo County,282424,282231,283159,-193,928,626,2357,687,2671,-61,-314,0,-24,-110,1233,-110,1209,-22,33,16055,16055,16055,8.337607669,9.44834539,-1.110737721,-0.084897151,4.361591114,4.276693964
50,4,9,6,81,California,San Mateo County,764442,762453,737888,-1989,-24565,1955,7828,1292,5754,663,2074,82,796,-2735,-27028,-2653,-26232,1,-407,8867,8867,8867,10.43496112,7.670256295,2.764704824,1.061092112,-36.02914271,-34.9680506
50,4,9,6,83,California,Santa Barbara County,448229,448096,446475,-133,-1621,1419,5303,909,3632,510,1671,7,91,-653,-3418,-646,-3327,3,35,19813,19813,19813,11.85596224,8.120093319,3.735868925,0.203449475,-7.641651697,-7.438202222
50,4,9,6,85,California,Santa Clara County,1936259,1930598,1885508,-5661,-45090,5032,19843,2846,13008,2186,6835,47,3563,-7987,-54801,-7940,-51238,93,-687,30151,30151,30151,10.3996063,6.81742069,3.58218561,1.867348549,-28.72090031,-26.85355176
50,4,9,6,87,California,Santa Cruz County,270861,270353,267792,-508,-2561,590,2258,465,2226,125,32,-5,-6,-623,-2596,-628,-2602,-5,9,13456,13456,13456,8.391790317,8.272863262,0.118927055,-0.022298823,-9.647957335,-9.670256158
50,4,9,6,89,California,Shasta County,182155,181893,182139,-262,246,465,1826,633,2480,-168,-654,1,53,-82,834,-81,887,-13,13,2851,2851,2851,10.03208509,13.62517581,-3.593090717,0.291183193,4.582014768,4.873197961
50,4,9,6,91,California,Sierra County,3236,3228,3283,-8,55,6,15,8,40,-2,-25,0,0,-4,80,-4,80,-2,0,33,33,33,4.60758716,12.28689909,-7.679311934,0,24.57379819,24.57379819
50,4,9,6,93,California,Siskiyou County,44076,43962,44118,-114,156,79,370,142,617,-63,-247,0,-1,-45,407,-45,406,-6,-3,563,563,563,8.401453224,14.00999092,-5.608537693,-0.02270663,9.241598547,9.218891916
50,4,9,6,95,California,Solano County,453491,453274,451716,-217,-1558,1260,4957,976,4157,284,800,6,73,-505,-2495,-499,-2422,-2,64,11840,11840,11840,10.95481718,9.186841844,1.767975337,0.16132775,-5.513873081,-5.352545332
50,4,9,6,97,California,Sonoma County,488863,488345,485887,-518,-2458,1140,4290,1144,4933,-4,-643,-13,8,-468,-1888,-481,-1880,-33,65,10061,10061,10061,8.806937157,10.12695128,-1.320014124,0.016423193,-3.875873509,-3.859450316
50,4,9,6,99,California,Stanislaus County,552878,552710,552999,-168,289,1755,7180,1346,5094,409,2086,-12,-50,-592,-1870,-604,-1920,27,123,6164,6164,6164,12.98714219,9.213997535,3.773144652,-0.090439709,-3.38244511,-3.472884819
50,4,9,6,101,California,Sutter County,99633,99480,99063,-153,-417,308,1218,223,964,85,254,-2,14,-237,-697,-239,-683,1,12,692,692,692,12.26938245,9.710742761,2.55863969,0.141027385,-7.021149071,-6.880121686
50,4,9,6,103,California,Tehama County,65829,65615,65498,-214,-117,160,751,207,768,-47,-17,0,-13,-164,-100,-164,-113,-3,13,750,750,750,11.45576716,11.71508546,-0.259318298,-0.198302228,-1.525401753,-1.723703981
50,4,9,6,105,California,Trinity County,16112,16088,16060,-24,-28,23,95,35,178,-12,-83,0,-1,-8,58,-8,57,-4,-2,420,420,420,5.910165485,11.07378375,-5.163618266,-0.062212268,3.608311559,3.546099291
50,4,9,6,107,California,Tulare County,473117,473736,477054,619,3318,1642,6584,976,3890,666,2694,-20,-157,-56,667,-76,510,29,114,4746,4746,4746,13.84953565,8.182669149,5.666866501,-0.330251685,1.403043785,1.072792099
50,4,9,6,109,California,Tuolumne County,55620,55516,55810,-104,294,101,424,200,694,-99,-270,0,10,5,558,5,568,-10,-4,3965,3965,3965,7.617268203,12.46788711,-4.850618903,0.179652552,10.0246124,10.20426495
50,4,9,6,111,California,Ventura County,843843,842921,839784,-922,-3137,2067,8380,1753,7178,314,1202,-42,-176,-1196,-4278,-1238,-4454,2,115,10900,10900,10900,9.960153443,8.531501362,1.428652081,-0.209186994,-5.084670218,-5.293857212
50,4,9,6,113,California,Yolo County,216403,216255,216986,-148,731,459,2004,366,1563,93,441,9,278,-259,-46,-250,232,9,58,9714,9714,9714,9.251201987,7.215383586,2.035818401,1.283350375,-0.21235294,1.070997436
50,4,9,6,115,California,Yuba County,81575,81932,83421,357,1489,268,1151,173,674,95,477,1,-4,255,1017,256,1013,6,-1,1157,1157,1157,13.92173108,8.152256082,5.769475002,-0.048381342,12.30095614,12.2525748
40,4,8,8,0,Colorado,Colorado,5773714,5784308,5812069,10594,27761,15242,60675,11835,47988,3407,12687,39,1677,6980,13054,7019,14731,168,343,112718,112718,112718,10.46447524,8.276378045,2.188097196,0.289228265,2.251392827,2.540621092
50,4,8,8,1,Colorado,Adams County,519572,520163,522140,591,1977,1590,6252,1005,3902,585,2350,11,149,-43,-617,-32,-468,38,95,3711,3711,3711,11.99651157,7.487266179,4.509245392,0.285905346,-1.183916769,-0.898011423
50,4,8,8,3,Colorado,Alamosa County,16376,16362,16547,-14,185,42,184,35,123,7,61,-1,0,-20,123,-21,123,0,1,824,824,824,11.18235133,7.475158771,3.707192561,0,7.475158771,7.475158771
50,4,8,8,5,Colorado,Arapahoe County,655070,655112,654900,42,-212,1844,7173,1258,5228,586,1945,39,435,-602,-2720,-563,-2285,19,128,4621,4621,4621,10.95104472,7.981606275,2.969438448,0.664116054,-4.152633716,-3.488517662
50,4,8,8,7,Colorado,Archuleta County,13359,13424,13790,65,366,30,98,26,116,4,-18,0,5,63,384,63,389,-2,-5,60,60,60,7.202175351,8.525023885,-1.322848534,0.367457926,28.22076872,28.58822665
50,4,8,8,9,Colorado,Baca County,3506,3486,3514,-20,28,15,38,21,56,-6,-18,0,0,-14,47,-14,47,0,-1,63,63,63,10.85714286,16,-5.142857143,0,13.42857143,13.42857143
50,4,8,8,11,Colorado,Bent County,5650,5635,5759,-15,124,12,44,19,58,-7,-14,0,0,-9,141,-9,141,1,-3,1537,1537,1537,7.723363174,10.18079691,-2.457433737,0,24.74986835,24.74986835
50,4,8,8,13,Colorado,Boulder County,330758,330811,329543,53,-1268,605,2415,550,2319,55,96,8,191,-11,-1604,-3,-1413,1,49,10435,10435,10435,7.314258716,7.023505574,0.290753142,0.578477604,-4.858000406,-4.279522801
50,4,8,8,14,Colorado,Broomfield County,74112,74513,75325,401,812,164,619,117,504,47,115,0,28,350,662,350,690,4,7,254,254,254,8.26225657,6.727265447,1.534991124,0.373736969,8.836209773,9.209946743
50,4,8,8,15,Colorado,Chaffee County,19476,19571,20074,95,503,38,133,52,202,-14,-69,0,3,111,579,111,582,-2,-10,1221,1221,1221,6.709547232,10.19044016,-3.480892925,0.151343171,29.20923193,29.3605751
50,4,8,8,17,Colorado,Cheyenne County,1748,1736,1707,-12,-29,4,17,8,21,-4,-4,0,5,-7,-30,-7,-25,-1,0,33,33,33,9.875108917,12.19866396,-2.323555039,2.904443799,-17.42666279,-14.522219
50,4,8,8,19,Colorado,Clear Creek County,9397,9404,9446,7,42,20,55,13,63,7,-8,0,2,0,49,0,51,0,-1,60,60,60,5.835543767,6.684350133,-0.848806366,0.212201592,5.198938992,5.411140584
50,4,8,8,21,Colorado,Conejos County,7461,7464,7612,3,148,34,83,19,73,15,10,0,0,-11,137,-11,137,-1,1,7,7,7,11.01087822,9.684266384,1.326611833,0,18.17458212,18.17458212
50,4,8,8,23,Colorado,Costilla County,3499,3506,3625,7,119,10,29,12,27,-2,2,0,4,9,116,9,120,0,-3,0,0,0,8.133501613,7.572570467,0.560931146,1.121862291,32.53400645,33.65586874
50,4,8,8,25,Colorado,Crowley County,5922,5893,6012,-29,119,8,23,26,59,-18,-36,0,3,-11,153,-11,156,0,-1,2707,2707,2707,3.863922722,9.911801764,-6.047879042,0.50398992,25.70348593,26.20747585
50,4,8,8,27,Colorado,Custer County,4704,4712,5045,8,333,5,47,14,63,-9,-16,0,0,17,356,17,356,0,-7,107,107,107,9.634108845,12.91380547,-3.279696628,0,72.97324997,72.97324997
50,4,8,8,29,Colorado,Delta County,31196,31232,31661,36,429,64,277,109,462,-45,-185,0,3,86,618,86,621,-5,-7,525,525,525,8.808611451,14.6916191,-5.883007648,0.095400124,19.65242555,19.74782567
50,4,8,8,31,Colorado,Denver County,715522,717630,711463,2108,-6167,2115,8755,1490,6019,625,2736,5,248,1418,-9115,1423,-8867,60,-36,15116,15116,15116,12.2525266,8.423524571,3.829002031,0.347073284,-12.75634266,-12.40926938
50,4,8,8,33,Colorado,Dolores County,2326,2338,2397,12,59,3,14,5,19,-2,-5,0,0,15,64,15,64,-1,0,0,0,0,5.913410771,8.025343189,-2.111932418,0,27.03273495,27.03273495
50,4,8,8,35,Colorado,Douglas County,357978,360102,368990,2124,8888,820,3446,465,2065,355,1381,4,104,1742,7452,1746,7556,23,-49,519,519,519,9.452853687,5.664580053,3.788273634,0.285286356,20.44186468,20.72715103
50,4,8,8,37,Colorado,Eagle County,55731,55665,55727,-66,62,140,513,35,163,105,350,4,19,-180,-314,-176,-295,5,7,43,43,43,9.210715312,2.926601551,6.28411376,0.341137604,-5.637747774,-5.296610169
50,4,8,8,39,Colorado,Elbert County,26062,26206,27128,144,922,44,231,38,200,6,31,0,5,138,902,138,907,0,-16,35,35,35,8.66239172,7.499906251,1.162485469,0.187497656,33.82457719,34.01207485
50,4,8,8,41,Colorado,El Paso County,730395,731847,737867,1452,6020,2210,8819,1558,5909,652,2910,-33,-41,797,3029,764,2988,36,122,19435,19435,19435,12.00097434,8.041020226,3.959954114,-0.055793168,4.121890381,4.066097214
50,4,8,8,43,Colorado,Fremont County,48939,48981,49661,42,680,75,386,152,628,-77,-242,-1,3,124,929,123,932,-4,-10,8021,8021,8021,7.826280895,12.73291296,-4.906632063,0.060826017,18.83579003,18.89661605
50,4,8,8,45,Colorado,Garfield County,61685,61776,62161,91,385,191,731,100,424,91,307,1,12,-3,56,-2,68,2,10,818,818,818,11.79631587,6.842185949,4.954129921,0.193646772,0.903684937,1.097331709
50,4,8,8,47,Colorado,Gilpin County,5808,5810,5873,2,63,7,36,8,39,-1,-3,0,5,3,60,3,65,0,1,21,21,21,6.162800651,6.676367371,-0.513566721,0.855944535,10.27133442,11.12727895
50,4,8,8,49,Colorado,Grand County,15717,15733,15860,16,127,31,124,14,70,17,54,0,2,0,70,0,72,-1,1,179,179,179,7.849840155,4.431361378,3.418478777,0.126610325,4.431361378,4.557971703
50,4,8,8,51,Colorado,Gunnison County,16918,16945,17281,27,336,31,129,22,100,9,29,-1,2,18,308,17,310,1,-3,876,876,876,7.538128908,5.843510781,1.694618127,0.116870216,17.99801321,18.11488342
50,4,8,8,53,Colorado,Hinsdale County,788,794,781,6,-13,1,4,0,5,1,-1,0,0,5,-11,5,-11,0,-1,55,55,55,5.079365079,6.349206349,-1.26984127,0,-13.96825397,-13.96825397
50,4,8,8,55,Colorado,Huerfano County,6820,6810,6920,-10,110,8,42,38,128,-30,-86,0,1,22,199,22,200,-2,-4,137,137,137,6.117989803,18.64530226,-12.52731245,0.145666424,28.98761835,29.13328478
50,4,8,8,57,Colorado,Jackson County,1379,1376,1363,-3,-13,2,7,3,9,-1,-2,0,0,-2,-10,-2,-10,0,-1,2,2,2,5.111354509,6.571741512,-1.460387003,0,-7.301935013,-7.301935013
50,4,8,8,59,Colorado,Jefferson County,582910,582928,579581,18,-3347,1404,5516,1314,5518,90,-2,8,82,-73,-3496,-65,-3414,-7,69,7804,7804,7804,9.489819004,9.493259837,-0.003440834,0.141074177,-6.014577091,-5.873502915
50,4,8,8,61,Colorado,Kiowa County,1446,1452,1452,6,0,2,14,5,14,-3,0,0,0,9,-1,9,-1,0,1,12,12,12,9.641873278,9.641873278,0,0,-0.688705234,-0.688705234
50,4,8,8,63,Colorado,Kit Carson County,7087,7064,6950,-23,-114,22,85,29,78,-7,7,0,3,-16,-123,-16,-120,0,-1,44,44,44,12.13072642,11.13172542,0.999000999,0.428143285,-17.5538747,-17.12573141
50,4,8,8,65,Colorado,Lake County,7436,7409,7407,-27,-2,18,71,11,32,7,39,0,-2,-35,-40,-35,-42,1,1,92,92,92,9.584233261,4.319654428,5.264578834,-0.269978402,-5.399568035,-5.669546436
50,4,8,8,67,Colorado,La Plata County,55638,55642,56250,4,608,98,462,98,477,0,-15,0,2,7,621,7,623,-3,0,1673,1673,1673,8.257963036,8.526078719,-0.268115683,0.035748758,11.09998928,11.13573803
50,4,8,8,69,Colorado,Larimer County,359066,359686,362533,620,2847,731,2960,695,2759,36,201,2,94,581,2508,583,2602,1,44,9675,9675,9675,8.196959648,7.64034178,0.556617868,0.260308854,6.945261756,7.20557061
50,4,8,8,71,Colorado,Las Animas County,14555,14564,14633,9,69,29,105,53,183,-24,-78,0,6,34,142,34,148,-1,-1,773,773,773,7.192519779,12.53553447,-5.343014693,0.41100113,9.727026749,10.13802788
50,4,8,8,73,Colorado,Lincoln County,5675,5669,5688,-6,19,12,48,11,55,1,-7,0,1,-7,24,-7,25,0,1,983,983,983,8.452936515,9.685656423,-1.232719908,0.176102844,4.226468258,4.402571102
50,4,8,8,75,Colorado,Logan County,21528,21495,21487,-33,-8,58,219,79,276,-21,-57,0,4,-12,41,-12,45,0,4,3302,3302,3302,10.19031222,12.84258527,-2.652273045,0.186124424,1.907775348,2.093899772
50,4,8,8,77,Colorado,Mesa County,155703,155939,157335,236,1396,382,1529,421,1877,-39,-348,-1,4,282,1734,281,1738,-6,6,4310,4310,4310,9.761422908,11.98312021,-2.2216973,0.025536751,11.07018138,11.09571813
50,4,8,8,79,Colorado,Mineral County,865,867,924,2,57,0,6,5,6,-5,0,0,0,6,59,6,59,1,-2,0,0,0,6.700167504,6.700167504,0,0,65.88498046,65.88498046
50,4,8,8,81,Colorado,Moffat County,13292,13267,13185,-25,-82,48,135,40,131,8,4,-2,7,-30,-95,-32,-88,-1,2,79,79,79,10.2071677,9.904733102,0.302434599,0.529260547,-7.182821715,-6.653561167
50,4,8,8,83,Colorado,Montezuma County,25849,25858,26175,9,317,55,235,70,341,-15,-106,0,14,26,414,26,428,-2,-5,177,177,177,9.03272923,13.10706667,-4.07433744,0.538120039,15.9129783,16.45109834
50,4,8,8,85,Colorado,Montrose County,42679,42798,43168,119,370,88,405,118,559,-30,-154,0,6,152,519,152,525,-3,-1,418,418,418,9.422329758,13.00514157,-3.582811809,0.139590071,12.0745411,12.21413117
50,4,8,8,87,Colorado,Morgan County,29111,29065,29008,-46,-57,116,402,102,300,14,102,0,37,-61,-198,-61,-161,1,2,488,488,488,13.84464381,10.33182374,3.512820071,1.274258261,-6.819003668,-5.544745407
50,4,8,8,89,Colorado,Otero County,18690,18667,18594,-23,-73,44,202,61,290,-17,-88,0,0,-5,12,-5,12,-1,3,472,472,472,10.84243579,15.56587317,-4.723437374,0,0.644105097,0.644105097
50,4,8,8,91,Colorado,Ouray County,4874,4869,5035,-5,166,12,18,16,22,-4,-4,0,0,-1,172,-1,172,0,-2,0,0,0,3.634894992,4.442649435,-0.807754443,0,34.73344103,34.73344103
50,4,8,8,93,Colorado,Park County,17390,17421,17720,31,299,46,128,24,142,22,-14,0,1,10,316,10,317,-1,-4,36,36,36,7.284937822,8.081727896,-0.796790074,0.056913577,17.98469025,18.04160383
50,4,8,8,95,Colorado,Phillips County,4530,4534,4512,4,-22,23,46,14,68,9,-22,-1,7,-5,-6,-6,1,1,-1,56,56,56,10.17024099,15.03426929,-4.8640283,1.547645368,-1.326553173,0.221092195
50,4,8,8,97,Colorado,Pitkin County,17358,17342,17348,-16,6,31,133,15,55,16,78,0,23,-32,-95,-32,-72,0,0,29,29,29,7.667915826,3.170942635,4.496973191,1.326030556,-5.477082733,-4.151052176
50,4,8,8,99,Colorado,Prowers County,11999,11986,11996,-13,10,43,148,49,142,-6,6,-1,0,-6,2,-7,2,0,2,264,264,264,12.34259028,11.842215,0.500375282,0,0.166791761,0.166791761
50,4,8,8,101,Colorado,Pueblo County,168162,168467,169622,305,1155,431,1723,590,2283,-159,-560,0,13,470,1699,470,1712,-6,3,3791,3791,3791,10.19258243,13.50531961,-3.312737179,0.076902827,10.05060798,10.1275108
50,4,8,8,103,Colorado,Rio Blanco County,6529,6518,6476,-11,-42,11,49,16,42,-5,7,0,5,-5,-53,-5,-48,-1,-1,258,258,258,7.541942435,6.464522087,1.077420348,0.769585963,-8.157611205,-7.388025242
50,4,8,8,105,Colorado,Rio Grande County,11539,11538,11408,-1,-130,25,105,33,142,-8,-37,0,2,8,-96,8,-94,-1,1,184,184,184,9.151921904,12.37688486,-3.224962957,0.174322322,-8.367471455,-8.193149133
50,4,8,8,107,Colorado,Routt County,24829,24839,25091,10,252,57,183,24,139,33,44,0,11,-23,196,-23,207,0,1,257,257,257,7.330262367,5.567794913,1.762467454,0.440616864,7.850991388,8.291608252
50,4,8,8,109,Colorado,Saguache County,6368,6383,6471,15,88,15,49,25,84,-10,-35,0,3,26,123,26,126,-1,-3,5,5,5,7.624085888,13.06986152,-5.445775634,0.466780769,19.13801151,19.60479228
50,4,8,8,111,Colorado,San Juan County,705,710,733,5,23,1,0,3,9,-2,-9,0,0,8,32,8,32,-1,0,0,0,0,0,12.47401247,-12.47401247,0,44.35204435,44.35204435
50,4,8,8,113,Colorado,San Miguel County,8072,8055,8074,-17,19,16,51,8,30,8,21,0,9,-25,-14,-25,-5,0,3,7,7,7,6.324012648,3.72000744,2.604005208,1.116002232,-1.736003472,-0.62000124
50,4,8,8,115,Colorado,Sedgwick County,2404,2390,2336,-14,-54,2,14,13,37,-11,-23,0,0,-2,-32,-2,-32,-1,1,33,33,33,5.924672027,15.65806179,-9.733389759,0,-13.54210749,-13.54210749
50,4,8,8,117,Colorado,Summit County,31055,30971,30941,-84,-30,50,241,22,80,28,161,0,28,-113,-225,-113,-197,1,6,251,251,251,7.785243572,2.584313219,5.200930353,0.904509627,-7.268380928,-6.363871301
50,4,8,8,119,Colorado,Teller County,24710,24726,24926,16,200,28,178,53,234,-25,-56,0,0,42,261,42,261,-1,-5,72,72,72,7.169902522,9.425602191,-2.25569967,0,10.51317168,10.51317168
50,4,8,8,121,Colorado,Washington County,4817,4815,4861,-2,46,14,43,18,71,-4,-28,-1,2,2,73,1,75,1,-1,160,160,160,8.887970236,14.67548574,-5.787515502,0.413393964,15.0888797,15.50227367
50,4,8,8,123,Colorado,Weld County,328981,331358,340036,2377,8678,1134,4333,558,2340,576,1993,-2,99,1775,6631,1773,6730,28,-45,5434,5434,5434,12.90747311,6.970571676,5.936901432,0.294908802,19.75293196,20.04784076
50,4,8,8,125,Colorado,Yuma County,9988,9979,9941,-9,-38,33,115,30,118,3,-3,1,28,-12,-64,-11,-36,-1,1,157,157,157,11.54618474,11.84738956,-0.301204819,2.81124498,-6.425702811,-3.614457831
40,1,1,9,0,Connecticut,Connecticut,3605944,3600260,3605597,-5684,5337,8290,32671,9428,37646,-1138,-4975,413,4583,-4908,5134,-4495,9717,-51,595,109137,109137,109137,9.067901292,10.44872248,-1.380821185,1.272020802,1.424951952,2.696972754
50,1,1,9,1,Connecticut,Fairfield County,957419,955895,959768,-1524,3873,2291,9146,2129,8696,162,450,191,1810,-1889,1454,-1698,3264,12,159,19219,19219,19219,9.548652347,9.078841111,0.469811235,1.88968519,1.518012302,3.407697492
50,1,1,9,3,Connecticut,Hartford County,899498,897932,896854,-1566,-1078,2157,8558,2525,9904,-368,-1346,106,1251,-1296,-1161,-1190,90,-8,178,24667,24667,24667,9.536512988,11.03641326,-1.499900267,1.394038064,-1.293747555,0.100290508
50,1,1,9,5,Connecticut,Litchfield County,185186,184874,185000,-312,126,339,1331,538,2254,-199,-923,1,81,-98,959,-97,1040,-16,9,2394,2394,2394,7.19704548,12.18793427,-4.990888789,0.43798699,5.185549674,5.623536664
50,1,1,9,7,Connecticut,Middlesex County,164245,163923,164759,-322,836,321,1225,459,1822,-138,-597,2,88,-175,1341,-173,1429,-11,4,4870,4870,4870,7.454013302,11.08670387,-3.632690564,0.535471976,8.159862725,8.6953347
50,1,1,9,9,Connecticut,New Haven County,864835,863498,863700,-1337,202,2011,7980,2440,9516,-429,-1536,92,950,-984,619,-892,1569,-16,169,28367,28367,28367,9.240399769,11.01900303,-1.778603264,1.100047592,0.716767852,1.816815443
50,1,1,9,11,Connecticut,New London County,268555,268248,268805,-307,557,623,2325,709,2938,-86,-613,11,208,-220,921,-209,1129,-12,41,10719,10719,10719,8.658363327,10.94119202,-2.282828697,0.774597665,3.429829086,4.204426751
50,1,1,9,13,Connecticut,Tolland County,149788,149650,150293,-138,643,301,1112,306,1254,-5,-142,5,118,-139,652,-134,770,1,15,14418,14418,14418,7.414742134,8.361588702,-0.946846568,0.786816162,4.34749269,5.134308852
50,1,1,9,15,Connecticut,Windham County,116418,116240,116418,-178,178,247,994,322,1262,-75,-268,5,77,-107,349,-102,426,-1,20,4483,4483,4483,8.544730893,10.84854164,-2.303810744,0.661915773,3.000111752,3.662027525
40,3,5,10,0,Delaware,Delaware,989948,991886,1003384,1938,11498,2408,10311,2649,11655,-241,-1344,33,619,2180,12207,2213,12826,-34,16,24405,24405,24405,10.33544332,11.68262942,-1.347186095,0.620467405,12.23593799,12.8564054
50,3,5,10,1,Delaware,Kent County,181851,182256,184149,405,1893,446,2049,479,2119,-33,-70,5,95,436,1858,441,1953,-3,10,4360,4360,4360,11.18434519,11.56643605,-0.382090856,0.518551876,10.141783,10.66033488
50,3,5,10,3,Delaware,New Castle County,570719,570718,571708,-1,990,1419,5904,1405,5936,14,-32,27,426,-37,466,-10,892,-5,130,17502,17502,17502,10.33589922,10.39192035,-0.056021134,0.745781346,0.815807764,1.56158911
50,3,5,10,5,Delaware,Sussex County,237378,238912,247527,1534,8615,543,2358,765,3600,-222,-1242,1,98,1781,9883,1782,9981,-26,-124,2543,2543,2543,9.694946335,14.80144479,-5.106498451,0.402928219,40.63407745,41.03700567
40,3,5,11,0,District of Columbia,District of Columbia,689545,690093,670050,548,-20043,2145,8723,1387,6552,758,2171,51,1128,-292,-23030,-241,-21902,31,-312,37003,37003,37003,12.8265925,9.634281101,3.192311397,1.658649127,-33.86408635,-32.20543722
50,3,5,11,1,District of Columbia,District of Columbia,689545,690093,670050,548,-20043,2145,8723,1387,6552,758,2171,51,1128,-292,-23030,-241,-21902,31,-312,37003,37003,37003,12.8265925,9.634281101,3.192311397,1.658649127,-33.86408635,-32.20543722
40,3,5,12,0,Florida,Florida,21538187,21569932,21781128,31745,211196,50641,210305,63596,255553,-12955,-45248,2670,38590,43068,220890,45738,259480,-1038,-3036,412459,412459,412459,9.702415581,11.78993086,-2.087515276,1.780348624,10.19075428,11.9711029
50,3,5,12,1,Florida,Alachua County,278468,278684,279238,216,554,633,2573,582,2522,51,51,12,368,150,66,162,434,3,69,14882,14882,14882,9.22351153,9.040690276,0.182821255,1.319180817,0.236592212,1.555773029
50,3,5,12,3,Florida,Baker County,28259,28309,28715,50,406,81,350,79,310,2,40,0,2,47,364,47,366,1,0,2531,2531,2531,12.27553311,10.87261504,1.40291807,0.070145904,12.76655443,12.83670034
50,3,5,12,5,Florida,Bay County,175216,174461,179168,-755,4707,445,1908,525,2238,-80,-330,-2,104,-669,5001,-671,5105,-4,-68,3540,3540,3540,10.7909702,12.65733297,-1.86636277,0.588187055,28.28387943,28.87206649
50,3,5,12,7,Florida,Bradford County,28303,28364,28540,61,176,75,281,89,369,-14,-88,0,3,77,261,77,264,-2,0,4127,4127,4127,9.876282862,12.9692113,-3.092928441,0.105440742,9.17334458,9.278785323
50,3,5,12,9,Florida,Brevard County,606612,608007,616628,1395,8621,1218,4938,2252,8659,-1034,-3721,5,205,2477,12265,2482,12470,-53,-128,6418,6418,6418,8.064443691,14.1413564,-6.076912713,0.334793632,20.03045806,20.36525169
50,3,5,12,11,Florida,Broward County,1944375,1941516,1930983,-2859,-10533,4931,20130,4956,19099,-25,1031,246,5550,-3053,-17205,-2807,-11655,-27,91,15538,15538,15538,10.39638745,9.863914749,0.5324727,2.866366137,-8.885735025,-6.019368888
50,3,5,12,13,Florida,Calhoun County,13648,13615,13641,-33,26,31,121,57,207,-26,-86,0,0,-6,112,-6,112,-1,0,1531,1531,1531,8.878778984,15.18931611,-6.310537129,0,8.218373936,8.218373936
50,3,5,12,15,Florida,Charlotte County,186847,187960,194843,1113,6883,259,1002,831,3500,-572,-2498,6,120,1728,9406,1734,9526,-49,-145,2536,2536,2536,5.235068691,18.28616808,-13.05109939,0.626954334,49.14277056,49.7697249
50,3,5,12,17,Florida,Citrus County,153843,154403,158083,560,3680,260,1038,873,3242,-613,-2204,1,8,1207,5969,1208,5977,-35,-93,2146,2146,2146,6.643497629,20.74972959,-14.10623196,0.051202294,38.20331151,38.2545138
50,3,5,12,19,Florida,Clay County,218245,218797,222361,552,3564,505,2102,579,2351,-74,-249,1,49,628,3796,629,3845,-3,-32,1035,1035,1035,9.529465634,10.6583129,-1.128847261,0.222142634,17.20925383,17.43139646
50,3,5,12,21,Florida,Collier County,375752,377079,385980,1327,8901,777,3036,1034,4761,-257,-1725,79,708,1581,10016,1660,10724,-76,-98,3956,3956,3956,7.957444968,12.47872052,-4.52127555,1.855688748,26.25222951,28.10791826
50,3,5,12,23,Florida,Columbia County,69698,69889,70385,191,496,182,755,231,1030,-49,-275,0,20,241,752,241,772,-1,-1,5046,5046,5046,10.76464634,14.68554401,-3.920897672,0.285156194,10.72187291,11.0070291
50,3,5,12,27,Florida,DeSoto County,33976,34080,34408,104,328,87,374,112,455,-25,-81,3,39,127,369,130,408,-1,1,2966,2966,2966,10.92162131,13.28699918,-2.365377876,1.138885644,10.77561033,11.91449597
50,3,5,12,29,Florida,Dixie County,16759,16805,17102,46,297,39,170,55,252,-16,-82,0,-1,63,385,63,384,-1,-5,1678,1678,1678,10.02742797,14.86418734,-4.836759371,-0.05898487,22.7091751,22.65019023
50,3,5,12,31,Florida,Duval County,995567,996373,999935,806,3562,2961,12525,2627,10722,334,1803,81,959,372,646,453,1605,19,154,21014,21014,21014,12.54816391,10.74182942,1.806334494,0.960773588,0.647194722,1.60796831
50,3,5,12,33,Florida,Escambia County,321905,322424,322390,519,-34,915,3668,1108,4260,-193,-592,10,118,701,391,711,509,1,49,17734,17734,17734,11.3769242,13.21311262,-1.83618842,0.365997016,1.212752825,1.578749841
50,3,5,12,35,Florida,Flagler County,115378,115968,120932,590,4964,175,796,459,1624,-284,-828,-2,59,894,5822,892,5881,-18,-89,503,503,503,6.720135078,13.71042634,-6.990291262,0.498100464,49.15154073,49.6496412
50,3,5,12,37,Florida,Franklin County,12451,12456,12572,5,116,24,96,54,152,-30,-56,0,1,35,175,35,176,0,-4,1757,1757,1757,7.671408023,12.14639604,-4.474988013,0.0799105,13.98433754,14.06424804
50,3,5,12,39,Florida,Gadsden County,43826,43701,43714,-125,13,109,489,141,570,-32,-81,0,12,-90,80,-90,92,-3,2,2945,2945,2945,11.18801121,13.04124006,-1.853228851,0.274552422,1.830349482,2.104901905
50,3,5,12,41,Florida,Gilchrist County,17864,17928,18360,64,432,44,186,59,229,-15,-43,0,2,81,478,81,480,-2,-5,1059,1059,1059,10.25132275,12.62125221,-2.369929453,0.110229277,26.34479718,26.45502646
50,3,5,12,43,Florida,Glades County,12126,12179,12234,53,55,12,66,34,195,-22,-129,0,3,78,182,78,185,-3,-1,1150,1150,1150,5.406955311,15.97509524,-10.56813993,0.245770696,14.91008889,15.15585958
50,3,5,12,45,Florida,Gulf County,14192,14181,14363,-11,182,20,121,61,225,-41,-104,0,4,31,285,31,289,-1,-3,393,393,393,8.478139014,15.76513453,-7.286995516,0.280269058,19.9691704,20.24943946
50,3,5,12,47,Florida,Hamilton County,14004,13988,13993,-16,5,41,159,62,178,-21,-19,1,2,5,20,6,22,-1,2,2522,2522,2522,11.36485472,12.72291912,-1.358064401,0.142954148,1.429541475,1.572495622
50,3,5,12,49,Florida,Hardee County,25327,25313,25425,-14,112,68,347,62,230,6,117,1,12,-20,-21,-19,-9,-1,4,1324,1324,1324,13.67811108,9.066183137,4.611927944,0.473018251,-0.827781939,-0.354763688
50,3,5,12,51,Florida,Hendry County,39619,39707,40313,88,606,115,571,99,387,16,184,14,128,57,289,71,417,1,5,477,477,477,14.27143214,9.672581855,4.598850287,3.1992002,7.223194201,10.4223944
50,3,5,12,53,Florida,Hernando County,194515,195508,200638,993,5130,378,1604,842,3324,-464,-1720,0,57,1478,6903,1478,6960,-21,-110,1588,1588,1588,8.098024466,16.7816916,-8.683667133,0.28777269,34.85078734,35.13856003
50,3,5,12,55,Florida,Highlands County,101235,101222,103296,-13,2074,177,784,524,1880,-347,-1096,10,115,350,3098,360,3213,-26,-43,1354,1354,1354,7.666806834,18.38468986,-10.71788302,1.12459539,30.2956219,31.42021729
50,3,5,12,57,Florida,Hillsborough County,1459762,1463380,1478194,3618,14814,3910,16571,3437,14264,473,2307,293,2706,2808,9600,3101,12306,44,201,22292,22292,22292,11.26675719,9.69820919,1.568547995,1.839831328,6.527117795,8.366949123
50,3,5,12,59,Florida,Holmes County,19653,19622,19784,-31,162,41,193,75,298,-34,-105,0,0,4,270,4,270,-1,-3,1697,1697,1697,9.79546262,15.12460032,-5.329137695,0,13.70349693,13.70349693
50,3,5,12,61,Florida,Indian River County,159788,160345,163662,557,3317,280,1237,633,2563,-353,-1326,1,129,941,4566,942,4695,-32,-52,1147,1147,1147,7.635637502,15.82064585,-8.185008349,0.796279093,28.18457626,28.98085535
50,3,5,12,63,Florida,Jackson County,47319,47214,47694,-105,480,103,486,209,762,-106,-276,0,15,4,748,4,763,-3,-7,6437,6437,6437,10.24149703,16.05765584,-5.816158806,0.316095587,15.76263329,16.07872887
50,3,5,12,65,Florida,Jefferson County,14510,14560,14555,50,-5,36,116,61,192,-25,-76,0,9,76,64,76,73,-1,-2,1222,1222,1222,7.968401168,13.1890778,-5.220676627,0.618238022,4.396359265,5.014597287
50,3,5,12,67,Florida,Lafayette County,8226,8252,8382,26,130,21,58,21,106,0,-48,1,8,25,172,26,180,0,-2,1177,1177,1177,6.97366839,12.74498016,-5.771311771,0.961885295,20.68053385,21.64241914
50,3,5,12,69,Florida,Lake County,383956,385875,395804,1919,9929,785,3370,1338,5542,-553,-2172,6,238,2505,12034,2511,12272,-39,-171,3885,3885,3885,8.622465232,14.17973363,-5.557268393,0.608945616,30.79013252,31.39907814
50,3,5,12,71,Florida,Lee County,760822,764679,787976,3857,23297,1639,6677,2278,9861,-639,-3184,94,949,4504,25864,4598,26813,-102,-332,7712,7712,7712,8.600751616,12.70211348,-4.101361861,1.222422238,33.31583642,34.53825866
50,3,5,12,73,Florida,Leon County,292198,292378,292817,180,439,720,2826,669,2503,51,323,4,189,121,-141,125,48,4,68,14609,14609,14609,9.658319022,8.554413486,1.103905536,0.645938533,-0.481890652,0.164047882
50,3,5,12,75,Florida,Levy County,42915,43051,44158,136,1107,93,411,144,670,-51,-259,0,9,191,1374,191,1383,-4,-17,307,307,307,9.425632676,15.3653866,-5.939753924,0.206400716,31.51050924,31.71690995
50,3,5,12,77,Florida,Liberty County,7974,7974,7900,0,-74,14,74,22,89,-8,-15,0,-5,8,-55,8,-60,0,1,1876,1876,1876,9.323421948,11.21330478,-1.889882827,-0.629960942,-6.929570367,-7.559531309
50,3,5,12,79,Florida,Madison County,17968,17976,18288,8,312,53,209,76,297,-23,-88,0,19,32,384,32,403,-1,-3,1792,1792,1792,11.52658284,16.37988087,-4.853298037,1.047871167,21.1780278,22.22589896
50,3,5,12,81,Florida,Manatee County,399710,401443,412703,1733,11260,816,3419,1271,5267,-455,-1848,14,208,2224,13060,2238,13268,-50,-160,4318,4318,4318,8.398984949,12.93871124,-4.53972629,0.510964864,32.0826977,32.59366256
50,3,5,12,83,Florida,Marion County,375908,377370,385915,1462,8545,795,3442,1669,6192,-874,-2750,-2,109,2388,11331,2386,11440,-50,-145,9187,9187,9187,9.018911678,16.22460811,-7.205696431,0.285607604,29.69008955,29.97569715
50,3,5,12,85,Florida,Martin County,158431,158529,159942,98,1413,308,1197,616,2501,-308,-1304,-3,49,441,2693,438,2742,-32,-25,3882,3882,3882,7.517167968,15.70629665,-8.18912868,0.307720326,16.91205793,17.21977825
50,3,5,12,86,Florida,Miami-Dade County,2701767,2692459,2662777,-9308,-29682,6772,27851,6840,26611,-68,1240,742,14195,-10011,-44787,-9269,-30592,29,-330,41295,41295,41295,10.40140901,9.938310842,0.463098172,5.301353666,-16.72643372,-11.42508005
50,3,5,12,87,Florida,Monroe County,82874,82809,82170,-65,-639,180,639,212,795,-32,-156,3,133,-29,-624,-26,-491,-7,8,2105,2105,2105,7.746440456,9.637590239,-1.891149783,1.612326417,-7.564599131,-5.952272713
50,3,5,12,89,Florida,Nassau County,90352,90993,94189,641,3196,213,812,261,1257,-48,-445,0,4,692,3688,692,3692,-3,-51,453,453,453,8.76975084,13.5758335,-4.806082665,0.043200743,39.8310851,39.87428584
50,3,5,12,91,Florida,Okaloosa County,211668,211809,213255,141,1446,608,2588,617,2288,-9,300,4,71,145,1047,149,1118,1,28,4971,4971,4971,12.17698982,10.76543768,1.411552143,0.33406734,4.926316978,5.260384319
50,3,5,12,93,Florida,Okeechobee County,39644,39641,40266,-3,625,117,500,139,554,-22,-54,2,12,19,672,21,684,-2,-5,2658,2658,2658,12.51454816,13.86611936,-1.351571202,0.300349156,16.81955273,17.11990189
50,3,5,12,95,Florida,Orange County,1429908,1429899,1422746,-9,-7153,3819,15764,2610,10606,1209,5158,427,3856,-1707,-16184,-1280,-12328,62,17,35935,35935,35935,11.05219892,7.435905975,3.616292949,2.703455916,-11.34666248,-8.643206568
50,3,5,12,97,Florida,Osceola County,388656,390855,403282,2199,12427,1102,4423,805,3056,297,1367,139,1251,1739,9914,1878,11165,24,-105,3101,3101,3101,11.13913594,7.696405028,3.442730914,3.150589886,24.96798411,28.118574
50,3,5,12,99,Florida,Palm Beach County,1492191,1492466,1497987,275,5521,3366,14241,4576,18623,-1210,-4382,277,3019,1380,6687,1657,9706,-172,197,21080,21080,21080,9.524309528,12.4549692,-2.930659669,2.019092091,4.472232133,6.491324224
50,3,5,12,101,Florida,Pasco County,561891,565745,584067,3854,18322,1237,5005,1869,7781,-632,-2776,7,251,4500,21155,4507,21406,-21,-308,5396,5396,5396,8.70577103,13.53438649,-4.828615461,0.436593113,36.79731991,37.23391302
50,3,5,12,103,Florida,Pinellas County,959107,958752,956615,-355,-2137,1806,7512,3577,14614,-1771,-7102,42,522,1492,4431,1534,4953,-118,12,18839,18839,18839,7.843927561,15.25973873,-7.415811174,0.545065254,4.62678954,5.171854793
50,3,5,12,105,Florida,Polk County,725046,729233,753520,4187,24287,1878,8086,2291,8962,-413,-876,69,578,4543,24939,4612,25517,-12,-354,13115,13115,13115,10.90673902,12.08832489,-1.181585874,0.779630862,33.63877868,34.41840954
50,3,5,12,107,Florida,Putnam County,73321,73347,74167,26,820,175,811,329,1188,-154,-377,-1,12,187,1193,186,1205,-6,-8,1210,1210,1210,10.99556652,16.10694578,-5.111379259,0.162696422,16.17473596,16.33743238
50,3,5,12,109,Florida,St. Johns County,273425,276916,292466,3491,15550,576,2145,593,2673,-17,-528,0,28,3508,16321,3508,16349,0,-271,2707,2707,2707,7.534484757,9.389127159,-1.854642402,0.098352249,57.32882318,57.42717543
50,3,5,12,111,Florida,St. Lucie County,329226,331275,343579,2049,12304,716,3035,1013,4429,-297,-1394,15,248,2354,13655,2369,13903,-23,-205,2719,2719,2719,8.994538078,13.12580203,-4.131263947,0.734973787,40.46801234,41.20298613
50,3,5,12,113,Florida,Santa Rosa County,188000,189133,193998,1133,4865,465,1877,479,2023,-14,-146,8,-24,1135,5092,1143,5068,4,-57,6042,6042,6042,9.798215232,10.56035664,-0.762141409,-0.125283519,26.58098666,26.45570314
50,3,5,12,115,Florida,Sarasota County,434006,435664,447057,1658,11393,647,2725,1820,7520,-1173,-4795,19,297,2917,16126,2936,16423,-105,-235,5512,5512,5512,6.174091247,17.03822612,-10.86413487,0.672919303,36.53702586,37.20994516
50,3,5,12,117,Florida,Seminole County,470856,471058,470093,202,-965,1053,4491,1040,4367,13,124,29,575,164,-1745,193,-1170,-4,81,3119,3119,3119,9.543633275,9.280126143,0.263507131,1.221908068,-3.708225354,-2.486317286
50,3,5,12,119,Florida,Sumter County,129752,130897,135638,1145,4741,115,434,651,2687,-536,-2253,-3,-8,1744,7113,1741,7105,-60,-111,7704,7704,7704,3.25660795,20.16245521,-16.90584726,-0.06002964,53.37385334,53.3138237
50,3,5,12,121,Florida,Suwannee County,43474,43510,44485,36,975,82,460,187,684,-105,-224,0,5,144,1209,144,1214,-3,-15,2287,2287,2287,10.4551395,15.54633786,-5.091198364,0.113642821,27.47883403,27.59247685
50,3,5,12,123,Florida,Taylor County,21796,21760,21815,-36,55,42,212,98,315,-56,-103,0,2,22,154,22,156,-2,2,2394,2394,2394,9.730349971,14.45783133,-4.727481354,0.091795754,7.068273092,7.160068847
50,3,5,12,125,Florida,Union County,16147,16126,16335,-21,209,35,144,73,294,-38,-150,0,0,16,364,16,364,1,-5,5108,5108,5108,8.872185084,18.11404455,-9.241859462,0,22.4269123,22.4269123
50,3,5,12,127,Florida,Volusia County,553543,554901,564412,1358,9511,1168,4650,2186,8523,-1018,-3873,16,269,2411,13264,2427,13533,-51,-149,13860,13860,13860,8.308667906,15.22898421,-6.920316301,0.480651971,23.70025185,24.18090382
50,3,5,12,129,Florida,Wakulla County,33764,33907,34690,143,783,63,316,87,402,-24,-86,0,0,166,878,166,878,1,-9,3182,3182,3182,9.213230899,11.72062918,-2.507398283,0,25.59878712,25.59878712
50,3,5,12,131,Florida,Walton County,75305,75855,80069,550,4214,179,844,237,884,-58,-40,0,10,608,4313,608,4323,0,-69,1889,1889,1889,10.82578692,11.33885739,-0.51307047,0.128267618,55.32182345,55.45009107
50,3,5,12,133,Florida,Washington County,25318,25357,25436,39,79,51,264,100,339,-49,-75,1,5,87,146,88,151,0,3,2488,2488,2488,10.39513319,13.34829603,-2.953162837,0.196877523,5.748823657,5.945701179
40,3,5,13,0,Georgia,Georgia,10711908,10725800,10799566,13892,73766,29463,121269,25664,105276,3799,15993,461,6997,9347,50632,9808,57629,285,144,253468,253468,253468,11.2675436,9.781575839,1.485967765,0.650116704,4.704403168,5.354519872
50,3,5,13,1,Georgia,Appling County,18444,18428,18488,-16,60,57,210,59,251,-2,-41,0,4,-14,95,-14,99,0,2,367,367,367,11.37718063,13.5984397,-2.221259075,0.216708202,5.146819807,5.36352801
50,3,5,13,3,Georgia,Atkinson County,8286,8301,8391,15,90,31,129,27,68,4,61,0,9,11,17,11,26,0,3,16,16,16,15.45650611,8.147615624,7.308890487,1.078360891,2.036903906,3.115264798
50,3,5,13,5,Georgia,Bacon County,11140,11123,11079,-17,-44,45,127,41,143,4,-16,0,-1,-21,-29,-21,-30,0,2,264,264,264,11.44041077,12.88172237,-1.441311594,-0.090081975,-2.612377263,-2.702459238
50,3,5,13,7,Georgia,Baker County,2876,2844,2819,-32,-25,5,20,18,36,-13,-16,0,0,-18,-9,-18,-9,-1,0,0,0,0,7.063393961,12.71410913,-5.650715169,0,-3.178527282,-3.178527282
50,3,5,13,9,Georgia,Baldwin County,43799,43773,43781,-26,8,82,399,153,579,-71,-180,0,13,45,169,45,182,0,6,5508,5508,5508,9.114375129,13.22612331,-4.111748178,0.296959591,3.860474679,4.157434269
50,3,5,13,11,Georgia,Banks County,18035,18069,18562,34,493,55,192,54,179,1,13,0,2,34,484,34,486,-1,-6,0,0,0,10.4829243,9.773142966,0.709781333,0.109197128,26.425705,26.53490213
50,3,5,13,13,Georgia,Barrow County,83505,83963,86658,458,2695,251,1065,177,785,74,280,0,54,378,2387,378,2441,6,-26,267,267,267,12.48380914,9.201680919,3.282128226,0.632981872,27.98014312,28.613125
50,3,5,13,15,Georgia,Bartow County,108901,109311,110843,410,1532,334,1272,304,1252,30,20,0,18,375,1495,375,1513,5,-1,892,892,892,11.55554748,11.37385648,0.181690998,0.163521898,13.58140211,13.74492401
50,3,5,13,17,Georgia,Ben Hill County,17194,17153,17158,-41,5,47,202,69,270,-22,-68,0,5,-19,66,-19,71,0,2,284,284,284,11.77464953,15.73839294,-3.963743406,0.291451721,3.847162718,4.138614439
50,3,5,13,19,Georgia,Berrien County,18160,18159,18147,-1,-12,53,220,63,278,-10,-58,0,0,10,43,10,43,-1,3,109,109,109,12.11920895,15.31427312,-3.195064177,0,2.368754476,2.368754476
50,3,5,13,21,Georgia,Bibb County,157346,157104,156762,-242,-342,460,1970,533,2051,-73,-81,0,58,-168,-350,-168,-292,-1,31,6788,6788,6788,12.55312777,13.0692716,-0.516143832,0.369584472,-2.230251126,-1.860666654
50,3,5,13,23,Georgia,Bleckley County,12583,12577,12607,-6,30,41,123,48,167,-7,-44,0,4,3,67,3,71,-2,3,1273,1273,1273,9.768106734,13.26238882,-3.494282084,0.317662008,5.320838628,5.638500635
50,3,5,13,25,Georgia,Brantley County,18021,18040,18101,19,61,47,203,51,277,-4,-74,0,2,23,131,23,133,0,2,45,45,45,11.23377881,15.32885089,-4.095072079,0.110677624,7.249384356,7.36006198
50,3,5,13,27,Georgia,Brooks County,16301,16232,16270,-69,38,28,171,65,226,-37,-55,0,10,-32,82,-32,92,0,1,51,51,51,10.52242939,13.9068365,-3.384407113,0.615346748,5.045843333,5.661190081
50,3,5,13,29,Georgia,Bryan County,44738,44999,46938,261,1939,131,580,93,327,38,253,1,-1,220,1709,221,1708,2,-22,118,118,118,12.61733578,7.113566899,5.503768885,-0.021754027,37.17763251,37.15587848
50,3,5,13,31,Georgia,Bulloch County,81099,81378,82442,279,1064,213,835,136,724,77,111,1,42,195,905,196,947,6,6,6499,6499,6499,10.19411549,8.838969601,1.355145892,0.512757905,11.048712,11.56146991
50,3,5,13,33,Georgia,Burke County,24596,24621,24310,25,-311,69,266,75,313,-6,-47,0,-1,31,-262,31,-263,0,-1,292,292,292,10.87245305,12.79352558,-1.921072531,-0.040873884,-10.70895751,-10.7498314
50,3,5,13,35,Georgia,Butts County,25434,25542,25781,108,239,64,265,81,348,-17,-83,-1,7,125,315,124,322,1,0,2961,2961,2961,10.32675409,13.56117141,-3.234417318,0.272782183,12.27519825,12.54798044
50,3,5,13,37,Georgia,Calhoun County,5573,5560,5509,-13,-51,8,54,32,44,-24,10,0,0,11,-61,11,-61,0,0,1437,1437,1437,9.75697895,7.950130997,1.806847954,0,-11.02177252,-11.02177252
50,3,5,13,39,Georgia,Camden County,54768,54911,55664,143,753,177,709,102,464,75,245,1,7,66,495,67,502,1,6,1894,1894,1894,12.8238752,8.392493783,4.431381415,0.126610898,8.953199186,9.079810084
50,3,5,13,43,Georgia,Candler County,10981,11001,11037,20,36,30,140,48,170,-18,-30,0,1,38,63,38,64,0,2,235,235,235,12.70532716,15.42789727,-2.722570106,0.090752337,5.717397223,5.80814956
50,3,5,13,45,Georgia,Carroll County,119148,119463,121968,315,2505,355,1555,309,1318,46,237,-3,41,268,2242,265,2283,4,-15,3877,3877,3877,12.88152723,10.91823337,1.96329386,0.339641554,18.57259424,18.91223579
50,3,5,13,47,Georgia,Catoosa County,67872,67976,68397,104,421,171,623,195,830,-24,-207,0,-2,130,629,130,627,-2,1,395,395,395,9.136705946,12.17249749,-3.035791542,-0.029331319,9.224699904,9.195368585
50,3,5,13,49,Georgia,Charlton County,12518,12530,12766,12,236,22,114,37,147,-15,-33,0,12,26,260,26,272,1,-3,2261,2261,2261,9.013282732,11.62239089,-2.609108159,0.948766603,20.55660974,21.50537634
50,3,5,13,51,Georgia,Chatham County,295291,294904,296329,-387,1425,815,3447,733,3039,82,408,4,229,-469,768,-465,997,-4,20,14823,14823,14823,11.66037755,10.28021102,1.380166533,0.774652294,2.597960533,3.372612828
50,3,5,13,53,Georgia,Chattahoochee County,9565,9482,9048,-83,-434,44,152,4,43,40,109,11,-12,-137,-521,-126,-533,3,-10,2294,2294,2294,16.40582839,4.641122504,11.76470588,-1.295196978,-56.23313546,-57.52833243
50,3,5,13,55,Georgia,Chattooga County,24965,24921,24932,-44,11,57,285,98,350,-41,-65,0,4,-1,69,-1,73,-2,3,1219,1219,1219,11.43361483,14.04128137,-2.60766654,0.160471787,2.768138327,2.928610114
50,3,5,13,57,Georgia,Cherokee County,266620,268043,274615,1423,6572,684,2588,475,2132,209,456,6,93,1198,6065,1204,6158,10,-42,1525,1525,1525,9.538235869,7.857619348,1.680616521,0.342757317,22.35293684,22.69569416
50,3,5,13,59,Georgia,Clarke County,128671,128489,128711,-182,222,313,1224,212,914,101,310,1,126,-291,-230,-290,-104,7,16,10378,10378,10378,9.517884915,7.107309487,2.410575428,0.979782271,-1.788491446,-0.808709176
50,3,5,13,61,Georgia,Clay County,2848,2835,2882,-13,47,7,27,14,35,-7,-8,0,2,-5,53,-5,55,-1,0,50,50,50,9.445513381,12.24418401,-2.798670631,0.699667658,18.54119293,19.24086059
50,3,5,13,63,Georgia,Clayton County,297595,297417,297100,-178,-317,984,3853,640,2227,344,1626,3,153,-550,-2139,-547,-1986,25,43,4723,4723,4723,12.96178242,7.491795861,5.469986561,0.514703532,-7.195757228,-6.681053696
50,3,5,13,65,Georgia,Clinch County,6749,6723,6725,-26,2,25,92,31,92,-6,0,0,2,-20,-1,-20,1,0,1,121,121,121,13.68233195,13.68233195,0,0.297441999,-0.148720999,0.148720999
50,3,5,13,67,Georgia,Cobb County,766149,766209,766802,60,593,2050,8419,1265,5819,785,2600,56,849,-815,-3003,-759,-2154,34,147,9402,9402,9402,10.98361329,7.591595886,3.392017409,1.107624146,-3.917780107,-2.810155961
50,3,5,13,69,Georgia,Coffee County,43092,43047,43386,-45,339,134,517,139,514,-5,3,0,26,-41,304,-41,330,1,6,3149,3149,3149,11.96302338,11.89360545,0.069417931,0.601622066,7.034350306,7.635972372
50,3,5,13,71,Georgia,Colquitt County,45898,45866,45812,-32,-54,150,558,154,578,-4,-20,-2,2,-25,-46,-27,-44,-1,10,1133,1133,1133,12.17304042,12.60935012,-0.436309693,0.043630969,-1.003512293,-0.959881324
50,3,5,13,73,Georgia,Columbia County,156010,156773,159639,763,2866,439,1676,310,1296,129,380,7,29,623,2468,630,2497,4,-11,538,538,538,10.59378279,8.191851131,2.401931659,0.183305311,15.59991404,15.78321935
50,3,5,13,75,Georgia,Cook County,17229,17232,17225,3,-7,46,191,56,240,-10,-49,0,0,13,39,13,39,0,3,101,101,101,11.08628145,13.93040601,-2.844124561,0,2.263690977,2.263690977
50,3,5,13,77,Georgia,Coweta County,146158,146653,149956,495,3303,382,1524,333,1343,49,181,0,60,439,3084,439,3144,7,-22,458,458,458,10.2761548,9.055692848,1.220461955,0.404573024,20.79505342,21.19962644
50,3,5,13,79,Georgia,Crawford County,12130,12100,12153,-30,53,31,85,45,161,-14,-76,0,0,-15,129,-15,129,-1,0,99,99,99,7.009442131,13.27670804,-6.267265905,0,10.63785923,10.63785923
50,3,5,13,81,Georgia,Crisp County,20128,20042,19879,-86,-163,66,240,91,321,-25,-81,0,0,-60,-86,-60,-86,-1,4,281,281,281,12.0237469,16.08176148,-4.058014579,0,-4.308509306,-4.308509306
50,3,5,13,83,Georgia,Dade County,16251,16224,16326,-27,102,38,138,67,237,-29,-99,0,0,3,201,3,201,-1,0,956,956,956,8.479262673,14.56221198,-6.082949309,0,12.35023042,12.35023042
50,3,5,13,85,Georgia,Dawson County,26798,27047,28497,249,1450,57,312,58,280,-1,32,0,5,251,1434,251,1439,-1,-21,90,90,90,11.23433674,10.08209708,1.152239666,0.180037448,51.63474003,51.81477747
50,3,5,13,87,Georgia,Decatur County,29367,29338,29038,-29,-300,97,331,115,429,-18,-98,3,5,-14,-209,-11,-204,0,2,1105,1105,1105,11.34027683,14.69782102,-3.357544196,0.171303275,-7.160476908,-6.989173633
50,3,5,13,89,Georgia,DeKalb County,764382,763831,757718,-551,-6113,2298,10049,1466,6134,832,3915,127,1506,-1531,-11455,-1404,-9949,21,-79,11569,11569,11569,13.2089075,8.062835965,5.146071536,1.979561618,-15.05702412,-13.07746251
50,3,5,13,91,Georgia,Dodge County,19925,19849,19759,-76,-90,43,194,82,317,-39,-123,0,6,-36,24,-36,30,-1,3,1664,1664,1664,9.796000808,16.0068673,-6.210866492,0.302969097,1.211876389,1.514845486
50,3,5,13,93,Georgia,Dooly County,11208,11142,10885,-66,-257,27,108,49,210,-22,-102,0,1,-43,-155,-43,-154,-1,-1,1480,1480,1480,9.806147001,19.06750806,-9.261361057,0.090797657,-14.0736369,-13.98283924
50,3,5,13,95,Georgia,Dougherty County,85790,85366,84844,-424,-522,266,1152,314,1190,-48,-38,0,18,-377,-516,-377,-498,1,14,4313,4313,4313,13.53621996,13.98272722,-0.446507256,0.211503437,-6.063098525,-5.851595088
50,3,5,13,97,Georgia,Douglas County,144237,144497,145814,260,1317,407,1631,335,1269,72,362,0,48,181,893,181,941,7,14,998,998,998,11.23622598,8.742348723,2.493877256,0.330679857,6.152023175,6.482703032
50,3,5,13,99,Georgia,Early County,10854,10813,10619,-41,-194,25,126,37,168,-12,-42,0,2,-29,-153,-29,-151,0,-1,133,133,133,11.7581187,15.6774916,-3.9193729,0.186636805,-14.27771557,-14.09107876
50,3,5,13,101,Georgia,Echols County,3697,3696,3699,-1,3,10,47,18,26,-8,21,0,0,7,-18,7,-18,0,0,0,0,0,12.71129141,7.031778229,5.679513185,0,-4.868154158,-4.868154158
50,3,5,13,103,Georgia,Effingham County,64769,65150,66741,381,1591,211,773,115,589,96,184,0,13,280,1408,280,1421,5,-14,523,523,523,11.72180058,8.931617775,2.790182803,0.197132481,21.35096405,21.54809653
50,3,5,13,105,Georgia,Elbert County,19637,19627,19579,-10,-48,33,211,93,337,-60,-126,0,1,52,74,52,75,-2,3,246,246,246,10.76365862,17.19124624,-6.427587614,0.0510126,3.774932408,3.825945008
50,3,5,13,107,Georgia,Emanuel County,22768,22730,22716,-38,-14,65,272,82,352,-17,-80,0,0,-21,62,-21,62,0,4,1307,1307,1307,11.97025041,15.49091229,-3.520661884,0,2.72851296,2.72851296
50,3,5,13,109,Georgia,Evans County,10774,10757,10672,-17,-85,33,131,40,152,-7,-21,0,3,-9,-67,-9,-64,-1,0,392,392,392,12.22642214,14.18638294,-1.959960801,0.2799944,-6.253208269,-5.973213869
50,3,5,13,111,Georgia,Fannin County,25319,25396,25817,77,421,44,180,121,400,-77,-220,0,-1,159,648,159,647,-5,-6,90,90,90,7.029465175,15.62103372,-8.591568547,-0.039052584,25.30607463,25.26702205
50,3,5,13,113,Georgia,Fayette County,119194,119441,120574,247,1133,204,851,269,1082,-65,-231,-1,71,322,1303,321,1374,-9,-10,449,449,449,7.091223465,9.01610316,-1.924879695,0.59162969,10.85765473,11.44928442
50,3,5,13,115,Georgia,Floyd County,98584,98593,98771,9,178,248,1076,320,1349,-72,-273,4,86,79,346,83,432,-2,19,3551,3551,3551,10.90371091,13.67017288,-2.766461969,0.871486188,3.506211873,4.37769806
50,3,5,13,117,Georgia,Forsyth County,251283,252786,260206,1503,7420,567,2224,358,1716,209,508,5,232,1275,6755,1280,6987,14,-75,559,559,559,8.670700518,6.69016281,1.980537708,0.904497536,26.33569334,27.24019088
50,3,5,13,119,Georgia,Franklin County,23424,23429,23785,5,356,67,288,108,369,-41,-81,0,13,46,429,46,442,0,-5,745,745,745,12.19977125,15.63095692,-3.431185665,0.550684119,18.17257593,18.72326005
50,3,5,13,121,Georgia,Fulton County,1066710,1069023,1065334,2313,-3689,2686,11798,1939,9072,747,2726,85,1236,1409,-7786,1494,-6550,72,135,33377,33377,33377,11.05532017,8.500920886,2.554399288,1.158194248,-7.29587412,-6.137679873
50,3,5,13,123,Georgia,Gilmer County,31353,31429,32026,76,597,67,305,105,451,-38,-146,-1,16,118,735,117,751,-3,-8,114,114,114,9.613111654,14.21479789,-4.601686234,0.504294382,23.16602317,23.67031755
50,3,5,13,125,Georgia,Glascock County,2884,2883,2919,-1,36,6,29,14,36,-8,-7,0,0,8,43,8,43,-1,0,64,64,64,9.996552913,12.40951396,-2.412961048,0,14.82247501,14.82247501
50,3,5,13,127,Georgia,Glynn County,84499,84470,84739,-29,269,182,835,280,1134,-98,-299,0,19,74,538,74,557,-5,11,1313,1313,1313,9.869451389,13.40354237,-3.534090976,0.224574343,6.358999817,6.58357416
50,3,5,13,129,Georgia,Gordon County,57544,57696,58237,152,541,161,655,170,684,-9,-29,0,39,159,526,159,565,2,5,537,537,537,11.29962996,11.79991892,-0.50028896,0.672802395,9.074206654,9.747009048
50,3,5,13,131,Georgia,Grady County,26236,26221,25918,-15,-303,66,291,52,322,14,-31,0,2,-29,-273,-29,-271,0,-1,196,196,196,11.16246955,12.35159861,-1.189129059,0.076718004,-10.47200752,-10.39528951
50,3,5,13,133,Georgia,Greene County,18915,19025,19536,110,511,29,162,53,295,-24,-133,0,12,136,641,136,653,-2,-9,143,143,143,8.402271725,15.30043308,-6.898161355,0.622390498,33.24602578,33.86841628
50,3,5,13,135,Georgia,Gwinnett County,957062,957801,964546,739,6745,2721,10585,1439,5835,1282,4750,119,1167,-742,681,-623,1848,80,147,4760,4760,4760,11.01257994,6.070704197,4.941875738,1.214140839,0.708508922,1.922649761
50,3,5,13,137,Georgia,Habersham County,46031,46105,46774,74,669,125,460,172,551,-47,-91,7,43,115,721,122,764,-1,-4,2303,2303,2303,9.905360738,11.86489949,-1.959538755,0.925935895,15.52557629,16.45151218
50,3,5,13,139,Georgia,Hall County,203136,203589,207369,453,3780,614,2503,522,2022,92,481,2,83,356,3221,358,3304,3,-5,2663,2663,2663,12.18129347,9.840421649,2.340871817,0.403934222,15.67556782,16.07950204
50,3,5,13,141,Georgia,Hancock County,8735,8722,8630,-13,-92,14,53,51,167,-37,-114,0,0,26,21,26,21,-2,1,1305,1305,1305,6.108805901,19.24850161,-13.13969571,0,2.420470263,2.420470263
50,3,5,13,143,Georgia,Haralson County,29919,29985,30572,66,587,85,379,143,438,-58,-59,-1,-1,125,655,124,654,0,-8,269,269,269,12.51713262,14.46570999,-1.948577373,-0.033026735,21.63251152,21.59948478
50,3,5,13,145,Georgia,Harris County,34668,34927,35626,259,699,72,286,56,406,16,-120,1,-1,243,831,244,830,-1,-11,305,305,305,8.107380267,11.50907828,-3.401698014,-0.028347483,23.55675875,23.52841127
50,3,5,13,147,Georgia,Hart County,25828,25866,26409,38,543,57,235,79,402,-22,-167,0,2,63,716,63,718,-3,-8,564,564,564,8.990913439,15.38020086,-6.389287422,0.076518412,27.39359158,27.47011
50,3,5,13,149,Georgia,Heard County,11412,11465,11565,53,100,44,111,32,136,12,-25,0,0,40,124,40,124,1,1,59,59,59,9.639600521,11.81068172,-2.171081198,0,10.76856274,10.76856274
50,3,5,13,151,Georgia,Henry County,240712,241818,245235,1106,3417,617,2560,459,2081,158,479,-1,45,938,2904,937,2949,11,-11,887,887,887,10.51220298,8.545271254,1.96693173,0.184784818,11.92478026,12.10956508
50,3,5,13,153,Georgia,Houston County,163633,164242,166829,609,2587,470,1922,402,1593,68,329,2,25,533,2238,535,2263,6,-5,1481,1481,1481,11.61080252,9.623313428,1.987489088,0.151025007,13.5197586,13.67078361
50,3,5,13,155,Georgia,Irwin County,9666,9643,9618,-23,-25,24,100,34,128,-10,-28,-1,0,-13,1,-14,1,1,2,1141,1141,1141,10.38367686,13.29110638,-2.907429521,0,0.103836769,0.103836769
50,3,5,13,157,Georgia,Jackson County,75907,76712,80286,805,3574,213,905,180,796,33,109,-1,14,768,3505,767,3519,5,-54,639,639,639,11.52880928,10.14025656,1.38855272,0.178346221,44.65025032,44.82859654
50,3,5,13,159,Georgia,Jasper County,14588,14638,15278,50,640,30,147,50,185,-20,-38,0,2,69,689,69,691,1,-13,77,77,77,9.827517048,12.36796363,-2.540446584,0.133707715,46.0623078,46.19601551
50,3,5,13,161,Georgia,Jeff Davis County,14779,14777,14872,-2,95,40,193,61,196,-21,-3,0,2,19,93,19,95,0,3,51,51,51,13.01898884,13.22135654,-0.202367702,0.134911801,6.273398766,6.408310567
50,3,5,13,163,Georgia,Jefferson County,15709,15658,15524,-51,-134,40,174,82,260,-42,-86,0,1,-8,-51,-8,-50,-1,2,579,579,579,11.16028478,16.6762876,-5.516002822,0.064139568,-3.271117953,-3.206978385
50,3,5,13,165,Georgia,Jenkins County,8674,8662,8639,-12,-23,11,95,25,130,-14,-35,0,8,2,3,2,11,0,1,1112,1112,1112,10.98202416,15.02803306,-4.046008901,0.924802035,0.346800763,1.271602798
50,3,5,13,167,Georgia,Johnson County,9189,9168,9160,-21,-8,20,110,37,137,-17,-27,0,0,-4,19,-4,19,0,0,1502,1502,1502,12.00349193,14.94980358,-2.946311654,0,2.073330423,2.073330423
50,3,5,13,169,Georgia,Jones County,28347,28356,28400,9,44,53,237,91,328,-38,-91,0,1,49,132,49,133,-2,2,195,195,195,8.351539925,11.55824935,-3.206709423,0.035238565,4.651490591,4.686729156
50,3,5,13,171,Georgia,Lamar County,18500,18550,19080,50,530,48,199,62,267,-14,-68,0,3,64,603,64,606,0,-8,1013,1013,1013,10.57666755,14.19080521,-3.614137656,0.15944725,32.04889716,32.20834441
50,3,5,13,173,Georgia,Lanier County,9877,9916,9907,39,-9,27,130,21,137,6,-7,0,6,32,-10,32,-4,1,2,153,153,153,13.11607728,13.8223276,-0.706250315,0.605357413,-1.008929022,-0.403571609
50,3,5,13,175,Georgia,Laurens County,49570,49497,49547,-73,50,138,557,196,688,-58,-131,0,4,-14,168,-14,172,-1,9,1157,1157,1157,11.24752635,13.89281531,-2.645288962,0.080772182,3.392431647,3.473203829
50,3,5,13,177,Georgia,Lee County,33163,33179,33411,16,232,79,324,99,301,-20,23,0,5,35,200,35,205,1,4,941,941,941,9.73119087,9.040396456,0.690794414,0.150172699,6.006907944,6.157080643
50,3,5,13,179,Georgia,Liberty County,65256,65220,65711,-36,491,325,1445,136,424,189,1021,3,-19,-232,-516,-229,-535,4,5,2375,2375,2375,22.07269478,6.476693831,15.59600095,-0.290229205,-7.882014191,-8.172243395
50,3,5,13,181,Georgia,Lincoln County,7690,7704,7749,14,45,14,67,21,116,-7,-49,0,0,23,94,23,94,-2,0,38,38,38,8.671455381,15.01326603,-6.341810652,0,12.16592248,12.16592248
50,3,5,13,183,Georgia,Long County,16168,16287,17152,119,865,69,245,31,140,38,105,2,-6,78,778,80,772,1,-12,177,177,177,14.65354825,8.373456144,6.280092108,-0.358862406,46.532492,46.17362959
50,3,5,13,185,Georgia,Lowndes County,118251,118316,119276,65,960,365,1587,303,1154,62,433,3,23,-5,480,-2,503,5,24,5899,5899,5899,13.35903566,9.714131789,3.644903869,0.193609212,4.040540086,4.234149298
50,3,5,13,187,Georgia,Lumpkin County,33488,33596,34278,108,682,67,266,91,345,-24,-79,0,8,133,759,133,767,-1,-6,2940,2940,2940,7.838052863,10.16589563,-2.327842767,0.235730913,22.36497039,22.6007013
50,3,5,13,189,Georgia,McDuffie County,21632,21587,21633,-45,46,58,259,70,297,-12,-38,0,-5,-32,86,-32,81,-1,3,235,235,235,11.98519204,13.74363721,-1.758445164,-0.231374364,3.979639056,3.748264692
50,3,5,13,191,Georgia,McIntosh County,10975,10982,11123,7,141,19,102,35,192,-16,-90,0,2,25,231,25,233,-2,-2,17,17,17,9.228681294,17.37163538,-8.142954083,0.180954535,20.90024881,21.08120335
50,3,5,13,193,Georgia,Macon County,12082,12021,12004,-61,-17,27,132,46,159,-19,-27,0,0,-41,8,-41,8,-1,2,1663,1663,1663,10.98855359,13.23621228,-2.247658689,0,0.665972945,0.665972945
50,3,5,13,195,Georgia,Madison County,30120,30263,30885,143,622,93,381,75,356,18,25,0,-2,125,604,125,602,0,-5,193,193,193,12.46156865,11.64388042,0.817688232,-0.065415059,19.75534768,19.68993262
50,3,5,13,197,Georgia,Marion County,7498,7520,7440,22,-80,16,82,22,103,-6,-21,0,0,29,-58,29,-58,-1,-1,17,17,17,10.96256685,13.77005348,-2.807486631,0,-7.754010695,-7.754010695
50,3,5,13,199,Georgia,Meriwether County,20613,20619,20793,6,174,57,240,80,312,-23,-72,0,0,30,248,30,248,-1,-2,173,173,173,11.59084323,15.0680962,-3.47725297,0,11.97720468,11.97720468
50,3,5,13,201,Georgia,Miller County,6000,5987,5919,-13,-68,12,63,20,89,-8,-26,0,0,-5,-40,-5,-40,0,-2,124,124,124,10.58289938,14.95044515,-4.367545775,0,-6.719301193,-6.719301193
50,3,5,13,205,Georgia,Mitchell County,21755,21677,21521,-78,-156,67,206,92,296,-25,-90,0,2,-53,-72,-53,-70,0,4,2041,2041,2041,9.537478587,13.70433816,-4.166859577,0.09259688,-3.333487661,-3.240890782
50,3,5,13,207,Georgia,Monroe County,27957,28046,28712,89,666,63,236,94,405,-31,-169,0,1,121,847,121,848,-1,-13,1057,1057,1057,8.316008316,14.27111597,-5.95510765,0.035237323,29.8460129,29.88125022
50,3,5,13,209,Georgia,Montgomery County,8610,8577,8653,-33,76,22,92,21,118,1,-26,0,0,-34,102,-34,102,0,0,698,698,698,10.67904817,13.69704005,-3.017991875,0,11.83981428,11.83981428
50,3,5,13,211,Georgia,Morgan County,20097,20174,20635,77,461,56,187,70,222,-14,-35,0,3,92,500,92,503,-1,-7,145,145,145,9.164645054,10.87995295,-1.715307898,0.147026391,24.50439854,24.65142493
50,3,5,13,213,Georgia,Murray County,39973,39938,39951,-35,13,101,433,142,490,-41,-57,0,-1,5,63,5,62,1,8,211,211,211,10.84004056,12.26702049,-1.426979935,-0.025034736,1.577188349,1.552153613
50,3,5,13,215,Georgia,Muscogee County,206922,206960,205617,38,-1343,691,2720,544,2283,147,437,14,83,-128,-1875,-114,-1792,5,12,7075,7075,7075,13.18541751,11.06702506,2.118392446,0.402349137,-9.089212438,-8.686863301
50,3,5,13,217,Georgia,Newton County,112483,112780,115355,297,2575,334,1293,295,1168,39,125,0,27,254,2449,254,2476,4,-26,1484,1484,1484,11.33539352,10.23955114,1.095842374,0.236701953,21.46974379,21.70644575
50,3,5,13,219,Georgia,Oconee County,41799,42021,43023,222,1002,100,322,82,331,18,-9,4,8,201,1015,205,1023,-1,-12,125,125,125,7.57255068,7.784205823,-0.211655143,0.188137905,23.86999671,24.05813461
50,3,5,13,221,Georgia,Oglethorpe County,14825,14865,15140,40,275,40,136,48,201,-8,-65,0,2,49,341,49,343,-1,-3,141,141,141,9.065155807,13.39776704,-4.332611231,0.133311115,22.72954508,22.86285619
50,3,5,13,223,Georgia,Paulding County,168661,169660,173780,999,4120,488,1851,337,1385,151,466,-1,36,836,3649,835,3685,13,-31,383,383,383,10.7791754,8.065455393,2.713720009,0.209643606,21.24970883,21.45935243
50,3,5,13,225,Georgia,Peach County,27981,28035,28417,54,382,85,333,88,305,-3,28,0,-1,56,355,56,354,1,0,1415,1415,1415,11.79763339,10.80564019,0.991993198,-0.035428328,12.57705661,12.54162829
50,3,5,13,227,Georgia,Pickens County,33216,33333,34024,117,691,68,277,95,440,-27,-163,0,-2,147,865,147,863,-3,-9,346,346,346,8.224831866,13.06471488,-4.839883011,-0.059385068,25.68404175,25.62465668
50,3,5,13,229,Georgia,Pierce County,19716,19722,19976,6,254,60,214,75,264,-15,-50,0,-2,21,307,21,305,0,-1,122,122,122,10.78139957,13.30041816,-2.51901859,-0.100760744,15.46677415,15.3660134
50,3,5,13,231,Georgia,Pike County,18889,18935,19477,46,542,48,202,47,218,1,-16,0,0,46,566,46,566,-1,-8,196,196,196,10.5175466,11.3506196,-0.833072998,0,29.46995731,29.46995731
50,3,5,13,233,Georgia,Polk County,42853,42925,43496,72,571,143,565,120,600,23,-35,0,16,48,592,48,608,1,-2,305,305,305,13.07552563,13.88551394,-0.809988313,0.370280372,13.70037375,14.07065412
50,3,5,13,235,Georgia,Pulaski County,9855,9863,9917,8,54,22,104,30,154,-8,-50,0,0,16,104,16,104,0,0,985,985,985,10.5156724,15.57128413,-5.055611729,0,10.5156724,10.5156724
50,3,5,13,237,Georgia,Putnam County,22047,22140,22585,93,445,38,210,70,339,-32,-129,0,1,127,580,127,581,-2,-7,90,90,90,9.390721073,15.15930688,-5.768585802,0.044717719,25.93627725,25.98099497
50,3,5,13,239,Georgia,Quitman County,2235,2224,2243,-11,19,5,22,13,32,-8,-10,0,0,-2,29,-2,29,-1,0,0,0,0,9.850011193,14.32728901,-4.477277815,0,12.98410566,12.98410566
50,3,5,13,241,Georgia,Rabun County,16883,16894,17119,11,225,41,152,89,294,-48,-142,0,2,61,369,61,371,-2,-4,372,372,372,8.937759092,17.28750772,-8.349748626,0.117602093,21.69758622,21.81518831
50,3,5,13,243,Georgia,Randolph County,6425,6377,6287,-48,-90,14,67,39,99,-25,-32,0,0,-22,-56,-22,-56,-1,-2,261,261,261,10.58117498,15.6348705,-5.053695515,0,-8.843967151,-8.843967151
50,3,5,13,245,Georgia,Richmond County,206607,206328,205673,-279,-655,628,2750,585,2468,43,282,1,21,-327,-990,-326,-969,4,32,12956,12956,12956,13.34948216,11.98055345,1.368928716,0.1019415,-4.805813578,-4.703872078
50,3,5,13,247,Georgia,Rockdale County,93570,93614,94082,44,468,253,911,249,901,4,10,-1,23,41,425,40,448,0,10,721,721,721,9.707186088,9.600630807,0.106555281,0.245077146,4.528599437,4.773676583
50,3,5,13,249,Georgia,Schley County,4547,4538,4478,-9,-60,16,50,10,49,6,1,1,0,-16,-61,-15,-61,0,0,0,0,0,11.09139308,10.86956522,0.221827862,0,-13.53149956,-13.53149956
50,3,5,13,251,Georgia,Screven County,14067,14060,14105,-7,45,32,176,58,199,-26,-23,0,0,19,66,19,66,0,2,441,441,441,12.49778093,14.13101367,-1.633232736,0,4.68666785,4.68666785
50,3,5,13,253,Georgia,Seminole County,9147,9138,9197,-9,59,24,92,31,126,-7,-34,0,0,0,93,0,93,-2,0,52,52,52,10.03545132,13.74420507,-3.70875375,0,10.14453232,10.14453232
50,3,5,13,255,Georgia,Spalding County,67306,67413,67909,107,496,219,815,260,990,-41,-175,0,2,150,665,150,667,-2,4,1267,1267,1267,12.0453437,14.63176719,-2.586423494,0.029559126,9.828409276,9.857968401
50,3,5,13,257,Georgia,Stephens County,26784,26800,26865,16,65,62,300,85,413,-23,-113,-1,3,40,174,39,177,0,1,567,567,567,11.18047144,15.39178235,-4.21131091,0.111804714,6.484673437,6.596478152
50,3,5,13,259,Georgia,Stewart County,5314,5295,5341,-19,46,8,35,15,74,-7,-39,1,92,-14,-7,-13,85,1,0,1233,1233,1233,6.581421587,13.91500564,-7.333584054,17.29973674,-1.316284317,15.98345243
50,3,5,13,261,Georgia,Sumter County,29616,29553,29283,-63,-270,73,342,107,386,-34,-44,0,3,-29,-230,-29,-227,0,1,1548,1548,1548,11.62553539,13.1212183,-1.495682915,0.101978381,-7.818342511,-7.716364131
50,3,5,13,263,Georgia,Talbot County,5733,5731,5742,-2,11,12,44,13,107,-1,-63,0,0,0,75,0,75,-1,-1,0,0,0,7.670182167,18.65248845,-10.98230628,0,13.07417415,13.07417415
50,3,5,13,265,Georgia,Taliaferro County,1559,1557,1558,-2,1,1,12,10,29,-9,-17,0,1,7,17,7,18,0,0,7,7,7,7.704654896,18.61958267,-10.91492777,0.642054575,10.91492777,11.55698234
50,3,5,13,267,Georgia,Tattnall County,22842,22852,23052,10,200,60,238,62,282,-2,-44,1,6,11,237,12,243,0,1,3888,3888,3888,10.36946671,12.28651098,-1.917044266,0.261415127,10.32589753,10.58731265
50,3,5,13,269,Georgia,Taylor County,7816,7814,7799,-2,-15,20,86,29,104,-9,-18,0,0,8,3,8,3,-1,0,137,137,137,11.01646064,13.32223147,-2.305770832,0,0.384295139,0.384295139
50,3,5,13,271,Georgia,Telfair County,12477,12461,12414,-16,-47,32,135,45,209,-13,-74,0,18,-2,7,-2,25,-1,2,2358,2358,2358,10.85427136,16.8040201,-5.949748744,1.447236181,0.56281407,2.010050251
50,3,5,13,273,Georgia,Terrell County,9185,9153,8964,-32,-189,25,97,44,108,-19,-11,0,0,-13,-175,-13,-175,0,-3,264,264,264,10.70817464,11.92250373,-1.214329083,0,-19.31887178,-19.31887178
50,3,5,13,275,Georgia,Thomas County,45798,45766,45842,-32,76,109,538,138,608,-29,-70,0,-2,-1,142,-1,140,-2,6,614,614,614,11.74569907,13.27394987,-1.528250808,-0.043664309,3.100165924,3.056501616
50,3,5,13,277,Georgia,Tift County,41344,41348,41212,4,-136,130,518,122,464,8,54,-1,-5,-3,-188,-4,-193,0,3,1540,1540,1540,12.54844961,11.24031008,1.308139535,-0.121124031,-4.554263566,-4.675387597
50,3,5,13,279,Georgia,Toombs County,27030,27052,26911,22,-141,107,363,115,395,-8,-32,0,3,31,-117,31,-114,-1,5,342,342,342,13.4536627,14.63966051,-1.185997813,0.111187295,-4.336304505,-4.22511721
50,3,5,13,281,Georgia,Towns County,12493,12539,12875,46,336,21,87,57,209,-36,-122,0,2,84,463,84,465,-2,-7,1176,1176,1176,6.846619973,16.44762729,-9.601007319,0.157393563,36.43660974,36.59400331
50,3,5,13,283,Georgia,Treutlen County,6406,6390,6306,-16,-84,20,65,27,98,-7,-33,-3,-3,-5,-48,-8,-51,-1,0,386,386,386,10.2394455,15.43793321,-5.198487713,-0.472589792,-7.561436673,-8.034026465
50,3,5,13,285,Georgia,Troup County,69426,69388,69720,-38,332,191,864,222,895,-31,-31,1,48,-8,305,-7,353,0,10,1973,1973,1973,12.42200305,12.86769992,-0.445696869,0.69011128,4.385082095,5.075193375
50,3,5,13,287,Georgia,Turner County,9006,8971,8966,-35,-5,19,118,41,93,-22,25,0,0,-13,-32,-13,-32,0,2,405,405,405,13.15716118,10.36962703,2.787534147,0,-3.568043709,-3.568043709
50,3,5,13,289,Georgia,Twiggs County,8022,7986,7856,-36,-130,10,68,46,167,-36,-99,0,4,1,-36,1,-32,-1,1,78,78,78,8.58477465,21.08319657,-12.49842192,0.504986744,-4.544880697,-4.039893953
50,3,5,13,291,Georgia,Union County,24632,24766,25521,134,755,34,160,121,412,-87,-252,0,-1,225,1025,225,1024,-4,-17,231,231,231,6.363473661,16.38594468,-10.02247102,-0.03977171,40.76600314,40.72623143
50,3,5,13,293,Georgia,Upson County,27700,27712,27720,12,8,69,306,124,471,-55,-165,3,1,65,169,68,170,-1,3,402,402,402,11.04055419,16.9937942,-5.953240006,0.036080243,6.097560976,6.133641218
50,3,5,13,295,Georgia,Walker County,67654,67711,68510,57,799,167,744,223,981,-56,-237,0,12,115,1031,115,1043,-2,-7,1148,1148,1148,10.9234259,14.40306561,-3.479639703,0.176184289,15.13716681,15.3133511
50,3,5,13,297,Georgia,Walton County,96673,97135,99853,462,2718,254,1089,265,1099,-11,-10,-1,13,473,2745,472,2758,1,-30,697,697,697,11.05651106,11.15804008,-0.101529027,0.131987735,27.86971795,28.00170569
50,3,5,13,299,Georgia,Ware County,36251,36218,36033,-33,-185,112,484,140,563,-28,-79,0,1,-4,-113,-4,-112,-1,6,2399,2399,2399,13.39773844,15.58455938,-2.186820944,0.027681278,-3.127984388,-3.10030311
50,3,5,13,301,Georgia,Warren County,5215,5205,5240,-10,35,12,62,28,76,-16,-14,0,0,5,50,5,50,1,-1,71,71,71,11.87170895,14.55241743,-2.680708473,0,9.573958832,9.573958832
50,3,5,13,303,Georgia,Washington County,19988,19927,19785,-61,-142,51,192,69,317,-18,-125,0,2,-43,-24,-43,-22,0,5,1766,1766,1766,9.669621273,15.96494762,-6.29532635,0.100725222,-1.208702659,-1.107977438
50,3,5,13,305,Georgia,Wayne County,30144,30155,30380,11,225,104,319,96,389,8,-70,0,3,3,292,3,295,0,0,1995,1995,1995,10.5393574,12.85206905,-2.312711654,0.099116214,9.647311473,9.746427687
50,3,5,13,307,Georgia,Webster County,2348,2350,2367,2,17,3,17,7,15,-4,2,0,0,6,15,6,15,0,0,0,0,0,7.207971168,6.35997456,0.847996608,0,6.35997456,6.35997456
50,3,5,13,309,Georgia,Wheeler County,7471,7430,7471,-41,41,10,60,24,73,-14,-13,0,0,-27,54,-27,54,0,0,2360,2360,2360,8.053150795,9.798000134,-1.744849339,0,7.247835716,7.247835716
50,3,5,13,311,Georgia,White County,28003,28090,28442,87,352,55,264,101,405,-46,-141,0,3,134,496,134,499,-1,-6,668,668,668,9.339842921,14.32816812,-4.988325196,0.106134579,17.54758367,17.65371825
50,3,5,13,313,Georgia,Whitfield County,102864,102727,102848,-137,121,298,1206,256,995,42,211,1,-18,-184,-97,-183,-115,4,25,952,952,952,11.73294418,9.68016539,2.052778791,-0.17511857,-0.943694515,-1.118813085
50,3,5,13,315,Georgia,Wilcox County,8766,8731,8739,-35,8,14,70,31,130,-17,-60,0,-1,-18,68,-18,67,0,1,1865,1865,1865,8.013737836,14.88265598,-6.868918145,-0.114481969,7.784773898,7.670291929
50,3,5,13,317,Georgia,Wilkes County,9565,9556,9513,-9,-43,31,73,36,157,-5,-84,0,0,-3,41,-3,41,-1,0,137,137,137,7.656405685,16.46651634,-8.810110651,0,4.300173056,4.300173056
50,3,5,13,319,Georgia,Wilkinson County,8877,8844,8831,-33,-13,33,87,46,117,-13,-30,0,0,-21,17,-21,17,1,0,158,158,158,9.844413013,13.23903819,-3.394625177,0,1.923620934,1.923620934
50,3,5,13,321,Georgia,Worth County,20784,20719,20554,-65,-165,54,185,82,236,-28,-51,0,1,-36,-117,-36,-116,-1,2,166,166,166,8.964698471,11.43604778,-2.471349308,0.04845783,-5.66956606,-5.621108231
40,4,9,15,0,Hawaii,Hawaii,1455271,1451911,1441553,-3360,-10358,4002,15904,3773,14648,229,1256,38,1077,-3571,-12603,-3533,-11526,-56,-88,42136,42136,42136,10.99305193,10.12488837,0.868163558,0.744436426,-8.711357736,-7.96692131
50,4,9,15,1,Hawaii,Hawaii County,200629,200746,202906,117,2160,511,2048,621,2358,-110,-310,11,198,232,2273,243,2471,-16,-1,3449,3449,3449,10.14735465,11.68333119,-1.535976534,0.981043077,11.26217633,12.24321941
50,4,9,15,3,Hawaii,Honolulu County,1016508,1013227,1000890,-3281,-12337,2884,11366,2559,9898,325,1468,23,652,-3603,-14338,-3580,-13686,-26,-119,35294,35294,35294,11.2863354,9.828624653,1.457710749,0.647430115,-14.23750457,-13.59007446
50,4,9,15,5,Hawaii,Kalawao County,82,82,82,0,0,0,0,0,0,0,0,0,0,0,0,0,0,0,0,3,3,3,0,0,0,0,0,0
50,4,9,15,7,Hawaii,Kauai County,73298,73201,73454,-97,253,180,724,162,764,18,-40,-1,70,-109,211,-110,281,-5,12,1077,1077,1077,9.873512666,10.4190106,-0.545497937,0.95462139,2.877501619,3.83212301
50,4,9,15,9,Hawaii,Maui County,164754,164655,164221,-99,-434,427,1766,431,1628,-4,138,5,157,-91,-749,-86,-592,-9,20,2313,2313,2313,10.73961007,9.900387988,0.839222078,0.954767146,-4.554908233,-3.600141087
40,4,8,16,0,Idaho,Idaho,1839106,1847772,1900923,8666,53151,5513,21316,4450,16918,1063,4398,-1,413,7563,48876,7562,49289,41,-536,28962,28962,28962,11.37249096,9.026074407,2.346416553,0.220343346,26.07627454,26.29661789
50,4,8,16,1,Idaho,Ada County,494967,497984,511931,3017,13947,1248,4814,1005,4135,243,679,-6,51,2756,13343,2750,13394,24,-126,11167,11167,11167,9.53347559,8.188807969,1.344667621,0.100998599,26.42400598,26.52500458
50,4,8,16,3,Idaho,Adams County,4379,4424,4625,45,201,10,37,10,44,0,-7,0,0,45,212,45,212,0,-4,16,16,16,8.177699193,9.724831473,-1.54713228,0,46.85600619,46.85600619
50,4,8,16,5,Idaho,Bannock County,87018,87177,88263,159,1086,262,1072,239,864,23,208,2,26,133,846,135,872,1,6,1781,1781,1781,12.22070223,9.849521204,2.371181031,0.296397629,9.644322845,9.940720474
50,4,8,16,7,Idaho,Bear Lake County,6372,6370,6545,-2,175,24,77,25,82,-1,-5,0,0,-1,184,-1,184,0,-4,28,28,28,11.92411924,12.6984127,-0.774293457,0,28.49399923,28.49399923
50,4,8,16,9,Idaho,Benewah County,9530,9576,9931,46,355,34,104,28,128,6,-24,0,0,42,385,42,385,-2,-6,54,54,54,10.66283898,13.12349413,-2.460655149,0,39.47300969,39.47300969
50,4,8,16,11,Idaho,Bingham County,47992,48068,48876,76,808,153,632,127,442,26,190,0,5,50,612,50,617,0,1,297,297,297,13.03845519,9.118666447,3.919788744,0.103152335,12.62584585,12.72899819
50,4,8,16,13,Idaho,Blaine County,24272,24327,24766,55,439,32,171,40,153,-8,18,3,80,62,341,65,421,-2,0,249,249,249,6.966369951,6.233067851,0.7333021,3.259120445,13.8920009,17.15112134
50,4,8,16,15,Idaho,Boise County,7610,7647,8094,37,447,10,45,14,91,-4,-46,0,13,42,490,42,503,-1,-10,25,25,25,5.717552887,11.56216251,-5.844609618,1.651737501,62.25779811,63.90953561
50,4,8,16,17,Idaho,Bonner County,47110,47390,49491,280,2101,108,387,112,549,-4,-162,0,-1,288,2303,288,2302,-4,-39,350,350,350,7.989182606,11.3334916,-3.344308998,-0.020643883,47.54286186,47.52221798
50,4,8,16,19,Idaho,Bonneville County,123964,124626,127930,662,3304,437,1791,278,1109,159,682,0,38,497,2607,497,2645,6,-23,1222,1222,1222,14.18299308,8.782210678,5.400782401,0.30092336,20.64492627,20.94584963
50,4,8,16,21,Idaho,Boundary County,12056,12113,12561,57,448,27,143,42,162,-15,-19,0,7,72,467,72,474,0,-7,34,34,34,11.59114858,13.13123126,-1.540082678,0.567398881,37.85361109,38.42100997
50,4,8,16,23,Idaho,Butte County,2574,2577,2654,3,77,8,27,12,25,-4,2,0,0,8,75,8,75,-1,0,10,10,10,10.32307398,9.558401835,0.764672147,0,28.67520551,28.67520551
50,4,8,16,25,Idaho,Camas County,1077,1089,1139,12,50,3,10,2,9,1,1,0,0,11,50,11,50,0,-1,0,0,0,8.976660682,8.078994614,0.897666068,0,44.88330341,44.88330341
50,4,8,16,27,Idaho,Canyon County,231105,232714,243115,1609,10401,778,3102,538,1980,240,1122,-2,-15,1355,9418,1353,9403,16,-124,3212,3212,3212,13.03829737,8.322317471,4.7159799,-0.06304786,39.58564947,39.52260161
50,4,8,16,29,Idaho,Caribou County,7027,7015,7111,-12,96,22,88,19,82,3,6,0,6,-16,84,-16,90,1,0,20,20,20,12.45929492,11.60979754,0.849497381,0.849497381,11.89296333,12.74246071
50,4,8,16,31,Idaho,Cassia County,24655,24699,25164,44,465,95,377,58,214,37,163,1,16,5,287,6,303,1,-1,244,244,244,15.12143273,8.583518842,6.537913884,0.641758418,11.51154162,12.15330004
50,4,8,16,33,Idaho,Clark County,790,792,792,2,0,4,7,2,2,2,5,0,0,0,-5,0,-5,0,0,1,1,1,8.838383838,2.525252525,6.313131313,0,-6.313131313,-6.313131313
50,4,8,16,35,Idaho,Clearwater County,8734,8750,8895,16,145,23,65,37,130,-14,-65,0,-1,30,215,30,214,0,-4,699,699,699,7.367526211,14.73505242,-7.367526211,-0.113346557,24.36950978,24.25616322
50,4,8,16,37,Idaho,Custer County,4275,4266,4428,-9,162,6,21,11,47,-5,-26,0,0,-4,192,-4,192,0,-4,19,19,19,4.830917874,10.81205429,-5.981136416,0,44.16839199,44.16839199
50,4,8,16,39,Idaho,Elmore County,28666,28668,28827,2,159,112,408,69,228,43,180,1,42,-43,-64,-42,-22,1,1,696,696,696,14.19253848,7.931124446,6.261414036,1.460996608,-2.226280546,-0.765283938
50,4,8,16,41,Idaho,Franklin County,14194,14269,14666,75,397,46,215,28,92,18,123,0,-1,56,278,56,277,1,-3,79,79,79,14.86089511,6.359080698,8.501814412,-0.069120442,19.21548298,19.14636254
50,4,8,16,43,Idaho,Fremont County,13388,13404,13592,16,188,41,163,33,127,8,36,0,1,8,152,8,153,0,-1,437,437,437,12.07586309,9.408801304,2.667061787,0.07408505,11.26092755,11.33501259
50,4,8,16,45,Idaho,Gem County,19123,19258,19792,135,534,63,192,71,260,-8,-68,0,1,143,607,143,608,0,-6,131,131,131,9.833546735,13.3162612,-3.482714469,0.051216389,31.08834827,31.13956466
50,4,8,16,47,Idaho,Gooding County,15598,15643,15772,45,129,42,183,54,174,-12,9,1,18,57,100,58,118,-1,2,23,23,23,11.65048544,11.07751074,0.572974694,1.145949387,6.366385485,7.512334872
50,4,8,16,49,Idaho,Idaho County,16541,16561,17040,20,479,29,136,65,210,-36,-74,0,0,59,562,59,562,-3,-9,473,473,473,8.094997173,12.49962799,-4.404630815,0,33.45138538,33.45138538
50,4,8,16,51,Idaho,Jefferson County,30891,31055,32202,164,1147,122,425,58,188,64,237,0,2,99,922,99,924,1,-14,159,159,159,13.43724805,5.944006197,7.493241855,0.063234109,29.15092401,29.21415812
50,4,8,16,53,Idaho,Jerome County,24237,24222,24662,-15,440,82,310,54,181,28,129,1,67,-46,243,-45,310,2,1,101,101,101,12.68308649,7.405285983,5.277800507,2.741183209,9.941903281,12.68308649
50,4,8,16,55,Idaho,Kootenai County,171362,172646,179789,1284,7143,487,1782,463,1815,24,-33,-1,-27,1261,7310,1260,7283,0,-107,1384,1384,1384,10.11250302,10.29977159,-0.187268574,-0.153219743,41.48282662,41.32960688
50,4,8,16,57,Idaho,Latah County,39517,39611,40313,94,702,119,407,80,272,39,135,2,43,52,525,54,568,1,-1,2569,2569,2569,10.18467544,6.806466143,3.378209299,1.076022221,13.13748061,14.21350283
50,4,8,16,59,Idaho,Lemhi County,7974,7948,8162,-26,214,15,67,43,110,-28,-43,-1,-1,5,263,4,262,-2,-5,56,56,56,8.317815022,13.65611422,-5.338299193,-0.124146493,32.65052762,32.52638113
50,4,8,16,61,Idaho,Lewis County,3533,3531,3715,-2,184,13,33,14,42,-1,-9,0,1,0,195,0,196,-1,-3,24,24,24,9.108473641,11.59260282,-2.484129175,0.276014353,53.82279879,54.09881314
50,4,8,16,63,Idaho,Lincoln County,5127,5133,5282,6,149,19,59,11,46,8,13,0,10,-2,127,-2,137,0,-1,17,17,17,11.32981277,8.833413346,2.496399424,1.920307249,24.38790206,26.30820931
50,4,8,16,65,Idaho,Madison County,52913,52876,53881,-37,1005,288,1092,31,196,257,896,-1,13,-298,87,-299,100,5,9,758,758,758,20.45767491,3.671890368,16.78578454,0.243543749,1.629869704,1.873413453
50,4,8,16,67,Idaho,Minidoka County,21613,21674,21955,61,281,71,290,66,192,5,98,0,2,56,179,56,181,0,2,68,68,68,13.29391001,8.801485251,4.492424763,0.091682138,8.205551354,8.297233492
50,4,8,16,69,Idaho,Nez Perce County,42090,42088,42454,-2,366,113,438,164,524,-51,-86,0,1,51,450,51,451,-2,1,1026,1026,1026,10.3617137,12.39620544,-2.034491732,0.023656881,10.64559627,10.66925315
50,4,8,16,71,Idaho,Oneida County,4564,4554,4611,-10,57,6,53,16,30,-10,23,0,0,0,33,0,33,0,1,43,43,43,11.56573923,6.546644845,5.019094381,0,7.201309329,7.201309329
50,4,8,16,73,Idaho,Owyhee County,11913,11978,12336,65,358,29,146,35,136,-6,10,0,1,71,352,71,353,0,-5,115,115,115,12.00954183,11.18697047,0.822571358,0.082257136,28.9545118,29.03676894
50,4,8,16,75,Idaho,Payette County,25386,25589,26350,203,761,85,319,62,291,23,28,0,-6,179,748,179,742,1,-9,141,141,141,12.28364042,11.20545255,1.078187874,-0.231040259,28.80301893,28.57197867
50,4,8,16,77,Idaho,Power County,7878,7879,7950,1,71,25,91,18,74,7,17,0,-6,-7,61,-7,55,1,-1,45,45,45,11.49788363,9.349927349,2.147956283,-0.758102217,7.707372544,6.949270327
50,4,8,16,79,Idaho,Shoshone County,13169,13189,13612,20,423,42,132,43,217,-1,-85,0,1,22,517,22,518,-1,-10,137,137,137,9.850378717,16.19342562,-6.343046901,0.074624081,38.58064998,38.65527406
50,4,8,16,81,Idaho,Teton County,11630,11731,12267,101,536,36,116,13,60,23,56,0,8,78,477,78,485,0,-5,2,2,2,9.667472289,5.000416701,4.667055588,0.666722227,39.75331278,40.420035
50,4,8,16,83,Idaho,Twin Falls County,90046,90279,92243,233,1964,295,1120,292,981,3,139,-1,22,229,1814,228,1836,2,-11,903,903,903,12.27249318,10.74938912,1.523104064,0.24106683,19.87705592,20.11812275
50,4,8,16,85,Idaho,Valley County,11746,11838,12241,92,403,30,80,27,98,3,-18,0,-3,91,432,91,429,-2,-8,44,44,44,6.644794219,8.139872918,-1.495078699,-0.249179783,35.88188878,35.632709
50,4,8,16,87,Idaho,Washington County,10500,10544,10898,44,354,19,89,41,126,-22,-37,0,-1,67,400,67,399,-1,-8,103,103,103,8.301464416,11.75263502,-3.4511706,-0.093274881,37.30995243,37.21667755
40,2,3,17,0,Illinois,Illinois,12812508,12785245,12671469,-27263,-113776,34072,133097,32486,130319,1586,2778,90,5766,-29052,-122460,-28962,-116694,113,140,289121,289121,289121,10.45673059,10.23847776,0.218252835,0.453004264,-9.621037499,-9.168033235
50,2,3,17,1,Illinois,Adams County,65737,65530,64954,-207,-576,152,750,232,942,-80,-192,0,3,-122,-392,-122,-389,-5,5,1909,1909,1909,11.4956623,14.43855185,-2.94288955,0.045982649,-6.008399497,-5.962416848
50,2,3,17,3,Illinois,Alexander County,5240,5168,5030,-72,-138,14,54,28,106,-14,-52,0,0,-57,-84,-57,-84,-1,-2,69,69,69,10.59031183,20.78838988,-10.19807805,0,-16.4738184,-16.4738184
50,2,3,17,5,Illinois,Bond County,16725,16663,16596,-62,-67,36,145,54,209,-18,-64,1,2,-44,-9,-43,-7,-1,4,1581,1581,1581,8.719444361,12.5680267,-3.848582339,0.120268198,-0.541206891,-0.420938693
50,2,3,17,7,Illinois,Boone County,53448,53326,53159,-122,-167,133,529,109,481,24,48,0,-3,-148,-217,-148,-220,2,5,259,259,259,9.935671691,9.034136263,0.901535428,-0.056345964,-4.075691412,-4.132037376
50,2,3,17,9,Illinois,Brown County,6244,6217,6421,-27,204,8,52,15,61,-7,-9,0,2,-20,213,-20,215,0,-2,1830,1830,1830,8.229150182,9.653426175,-1.424275993,0.316505776,33.70786517,34.02437095
50,2,3,17,11,Illinois,Bureau County,33244,33118,32883,-126,-235,86,312,153,456,-67,-144,0,3,-56,-100,-56,-97,-3,6,419,419,419,9.454402206,13.81797246,-4.363570249,0.090907714,-3.030257117,-2.939349404
50,2,3,17,13,Illinois,Calhoun County,4437,4411,4369,-26,-42,10,37,13,81,-3,-44,0,0,-21,1,-21,1,-2,1,47,47,47,8.428246014,18.45102506,-10.02277904,0,0.227790433,0.227790433
50,2,3,17,15,Illinois,Carroll County,15702,15664,15698,-38,34,25,126,53,217,-28,-91,0,2,-7,123,-7,125,-3,0,221,221,221,8.035201837,13.83840316,-5.803201326,0.127542886,7.843887507,7.971430394
50,2,3,17,17,Illinois,Cass County,13042,12956,12773,-86,-183,38,178,52,161,-14,17,0,23,-72,-222,-72,-199,0,-1,181,181,181,13.83652688,12.51506083,1.32146605,1.787865832,-17.25679195,-15.46892611
50,2,3,17,19,Illinois,Champaign County,205865,205469,205943,-396,474,543,2143,443,1707,100,436,23,566,-531,-575,-508,-9,12,47,15917,15917,15917,10.41778072,8.298250902,2.119529814,2.751499713,-2.795251475,-0.043751762
50,2,3,17,21,Illinois,Christian County,34032,33900,33662,-132,-238,76,343,127,505,-51,-162,0,2,-80,-82,-80,-80,-1,4,1618,1618,1618,10.15363666,14.94923182,-4.795595157,0.059204879,-2.427400018,-2.368195139
50,2,3,17,23,Illinois,Clark County,15455,15407,15300,-48,-107,53,152,58,231,-5,-79,0,0,-42,-30,-42,-30,-1,2,186,186,186,9.900022796,15.04542938,-5.145406585,0,-1.953951868,-1.953951868
50,2,3,17,25,Illinois,Clay County,13288,13267,13143,-21,-124,36,155,41,188,-5,-33,0,0,-15,-92,-15,-92,-1,1,278,278,278,11.73797804,14.23703143,-2.499053389,0,-6.967057933,-6.967057933
50,2,3,17,27,Illinois,Clinton County,36899,36896,36793,-3,-103,99,367,96,426,3,-59,0,4,-5,-57,-5,-53,-1,9,1925,1925,1925,9.960781121,11.56210561,-1.601324485,0.108564372,-1.547042299,-1.438477928
50,2,3,17,29,Illinois,Coles County,46863,46737,46765,-126,28,125,445,164,601,-39,-156,0,21,-88,157,-88,178,1,6,2895,2895,2895,9.518512973,12.85533999,-3.33682702,0.449188253,3.358216937,3.807405189
50,2,3,17,31,Illinois,Cook County,5275541,5262741,5173146,-12800,-89595,14260,56201,12228,50008,2032,6193,-78,3177,-14860,-98205,-14938,-95028,106,-760,92570,92570,92570,10.77071839,9.583852336,1.186866052,0.60886056,-18.82063307,-18.21177251
50,2,3,17,33,Illinois,Crawford County,18679,18639,18659,-40,20,44,177,53,250,-9,-73,0,-1,-30,93,-30,92,-1,1,1442,1442,1442,9.49112553,13.40554453,-3.914419004,-0.053622178,4.986862566,4.933240388
50,2,3,17,35,Illinois,Cumberland County,10450,10428,10345,-22,-83,29,123,33,128,-4,-5,0,1,-17,-79,-17,-78,-1,0,83,83,83,11.84229529,12.32368941,-0.481394117,0.096278824,-7.606027054,-7.509748231
50,2,3,17,37,Illinois,DeKalb County,100420,100233,100414,-187,181,290,1089,218,884,72,205,5,66,-270,-104,-265,-38,6,14,5202,5202,5202,10.85488445,8.811494814,2.043389635,0.657871785,-1.036646449,-0.378774664
50,2,3,17,39,Illinois,De Witt County,15516,15441,15341,-75,-100,45,147,71,247,-26,-100,0,1,-49,-2,-49,-1,0,1,202,202,202,9.55103632,16.04833994,-6.497303619,0.064973036,-0.129946072,-0.064973036
50,2,3,17,41,Illinois,Douglas County,19740,19742,19722,2,-20,52,258,55,206,-3,52,0,4,6,-79,6,-75,-1,3,142,142,142,13.07520778,10.43989459,2.635313197,0.2027164,-4.003648895,-3.800932495
50,2,3,17,43,Illinois,DuPage County,932877,931153,924885,-1724,-6268,2485,9480,1940,7878,545,1602,68,624,-2355,-8564,-2287,-7940,18,70,12537,12537,12537,10.21530809,8.489050332,1.72625776,0.672400026,-9.228259335,-8.555859309
50,2,3,17,45,Illinois,Edgar County,16866,16755,16520,-111,-235,30,157,80,276,-50,-119,0,0,-59,-116,-59,-116,-2,0,223,223,223,9.436513899,16.5890308,-7.152516905,0,-6.972201352,-6.972201352
50,2,3,17,47,Illinois,Edwards County,6245,6205,6075,-40,-130,11,52,33,87,-22,-35,0,0,-18,-94,-18,-94,0,-1,37,37,37,8.469055375,14.16938111,-5.700325733,0,-15.30944625,-15.30944625
50,2,3,17,49,Illinois,Effingham County,34668,34614,34430,-54,-184,95,400,111,412,-16,-12,0,7,-37,-183,-37,-176,-1,4,394,394,394,11.58681421,11.93441863,-0.347604426,0.202769249,-5.300967499,-5.09819825
50,2,3,17,51,Illinois,Fayette County,21488,21460,21384,-28,-76,53,216,63,271,-10,-55,0,2,-17,-26,-17,-24,-1,3,1608,1608,1608,10.08309215,12.65054617,-2.567454019,0.093361964,-1.213705536,-1.120343572
50,2,3,17,53,Illinois,Ford County,13534,13533,13511,-1,-22,41,125,46,193,-5,-68,0,0,4,46,4,46,0,0,396,396,396,9.244194646,14.27303653,-5.028841887,0,3.40186363,3.40186363
50,2,3,17,55,Illinois,Franklin County,37804,37636,37442,-168,-194,83,411,156,634,-73,-223,0,0,-93,22,-93,22,-2,7,428,428,428,10.94861344,16.889102,-5.940488559,0,0.586057167,0.586057167
50,2,3,17,57,Illinois,Fulton County,33609,33440,33197,-169,-243,64,275,140,551,-76,-276,0,1,-92,27,-92,28,-1,5,2562,2562,2562,8.253672884,16.53735913,-8.28368624,0.030013356,0.810360611,0.840373966
50,2,3,17,59,Illinois,Gallatin County,4946,4947,4903,1,-44,12,41,12,86,0,-45,0,0,2,0,2,0,-1,1,25,25,25,8.324873096,17.46192893,-9.137055838,0,0,0
50,2,3,17,61,Illinois,Greene County,11985,11915,11843,-70,-72,18,113,45,178,-27,-65,0,1,-42,-9,-42,-8,-1,1,204,204,204,9.512585234,14.9844263,-5.471841064,0.08418217,-0.757639532,-0.673457362
50,2,3,17,63,Illinois,Grundy County,52533,52514,52989,-19,475,152,568,131,510,21,58,0,17,-41,396,-41,413,1,4,228,228,228,10.76746633,9.667971527,1.099494801,0.322265718,7.506895539,7.829161256
50,2,3,17,65,Illinois,Hamilton County,7993,7977,7911,-16,-66,14,93,26,120,-12,-27,0,0,-3,-40,-3,-40,-1,1,80,80,80,11.70694864,15.10574018,-3.398791541,0,-5.035246727,-5.035246727
50,2,3,17,67,Illinois,Hancock County,17620,17552,17400,-68,-152,50,165,56,231,-6,-66,0,0,-60,-87,-60,-87,-2,1,183,183,183,9.441519799,13.21812772,-3.776607919,0,-4.978255894,-4.978255894
50,2,3,17,69,Illinois,Hardin County,3649,3634,3650,-15,16,4,31,16,66,-12,-35,0,0,-1,49,-1,49,-2,2,6,6,6,8.5118067,18.12191104,-9.610104338,0,13.45414607,13.45414607
50,2,3,17,71,Illinois,Henderson County,6387,6339,6312,-48,-27,10,48,23,95,-13,-47,0,0,-35,21,-35,21,0,-1,30,30,30,7.588332938,15.01857561,-7.430242669,0,3.31989566,3.31989566
50,2,3,17,73,Illinois,Henry County,49284,49138,48907,-146,-231,127,503,171,640,-44,-137,0,2,-99,-101,-99,-99,-3,5,674,674,674,10.26059463,13.05522974,-2.794635117,0.040797593,-2.060278444,-2.019480851
50,2,3,17,75,Illinois,Iroquois County,27077,26984,26827,-93,-157,89,308,97,418,-8,-110,0,0,-84,-51,-84,-51,-1,4,418,418,418,11.44747357,15.53585698,-4.088383416,0,-1.89552322,-1.89552322
50,2,3,17,77,Illinois,Jackson County,52974,52896,52565,-78,-331,164,519,153,579,11,-60,1,64,-91,-339,-90,-275,1,4,3135,3135,3135,9.842501019,10.98036241,-1.13786139,1.213718816,-6.428916851,-5.215198035
50,2,3,17,79,Illinois,Jasper County,9287,9247,9193,-40,-54,29,98,26,110,3,-12,0,2,-43,-45,-43,-43,0,1,31,31,31,10.62906725,11.93058568,-1.301518438,0.21691974,-4.880694143,-4.663774403
50,2,3,17,81,Illinois,Jefferson County,37113,37029,36877,-84,-152,122,413,112,567,10,-154,0,1,-92,-4,-92,-3,-2,5,2031,2031,2031,11.17635916,15.34381512,-4.167455958,0.027061402,-0.108245609,-0.081184207
50,2,3,17,83,Illinois,Jersey County,21512,21444,21333,-68,-111,40,192,96,286,-56,-94,0,2,-11,-21,-11,-19,-1,2,721,721,721,8.976786591,13.37167169,-4.394885102,0.093508194,-0.981836033,-0.88832784
50,2,3,17,85,Illinois,Jo Daviess County,22035,22035,21939,0,-96,37,161,67,277,-30,-116,0,-1,34,20,34,19,-4,1,155,155,155,7.322508755,12.59835357,-5.275844817,-0.045481421,0.909628417,0.864146996
50,2,3,17,87,Illinois,Johnson County,13308,13307,13463,-1,156,27,90,37,164,-10,-74,0,0,10,232,10,232,-1,-2,1322,1322,1322,6.723944714,12.25252148,-5.528576765,0,17.33283526,17.33283526
50,2,3,17,89,Illinois,Kane County,516522,516155,515588,-367,-567,1508,5633,970,4230,538,1403,-13,-7,-908,-2055,-921,-2062,16,92,6123,6123,6123,10.91938593,8.199716402,2.71966953,-0.013569271,-3.983550167,-3.997119438
50,2,3,17,91,Illinois,Kankakee County,107502,107236,106601,-266,-635,291,1207,330,1366,-39,-159,0,24,-228,-515,-228,-491,1,15,5940,5940,5940,11.28897244,12.77608646,-1.487114017,0.22447004,-4.816752947,-4.592282907
50,2,3,17,93,Illinois,Kendall County,131869,132291,134867,422,2576,381,1492,186,771,195,721,-1,28,219,1833,218,1861,9,-6,165,165,165,11.16942034,5.771865338,5.397555005,0.209613787,13.72221682,13.9318306
50,2,3,17,95,Illinois,Knox County,49967,49736,49268,-231,-468,132,463,212,745,-80,-282,1,47,-148,-236,-147,-189,-4,3,3882,3882,3882,9.353157448,15.04989697,-5.696739526,0.949456588,-4.767484142,-3.818027554
50,2,3,17,97,Illinois,Lake County,714342,713217,711239,-1125,-1978,1724,6681,1443,5809,281,872,74,184,-1506,-3119,-1432,-2935,26,85,18893,18893,18893,9.380423123,8.156096082,1.224327041,0.258344238,-4.379215644,-4.120871406
50,2,3,17,99,Illinois,LaSalle County,109658,109359,108965,-299,-394,293,1055,398,1519,-105,-464,0,11,-189,39,-189,50,-5,20,3275,3275,3275,9.664535278,13.91509866,-4.250563383,0.100767666,0.357267181,0.458034847
50,2,3,17,101,Illinois,Lawrence County,15280,15234,15152,-46,-82,35,123,51,225,-16,-102,0,3,-30,17,-30,20,0,0,2317,2317,2317,8.095833608,14.80945172,-6.713618114,0.197459356,1.118936352,1.316395709
50,2,3,17,103,Illinois,Lee County,34145,34021,34049,-124,28,68,285,114,490,-46,-205,0,2,-77,231,-77,233,-1,0,2977,2977,2977,8.373732922,14.39694432,-6.0232114,0.058763038,6.787130895,6.845893933
50,2,3,17,105,Illinois,Livingston County,35815,35752,35664,-63,-88,96,385,115,510,-19,-125,0,7,-43,23,-43,30,-1,7,2236,2236,2236,10.78189761,14.28251372,-3.500616108,0.196034502,0.644113364,0.840147866
50,2,3,17,107,Illinois,Logan County,27987,27879,27992,-108,113,68,263,116,366,-48,-103,0,4,-58,209,-58,213,-2,3,3950,3950,3950,9.414544218,13.10160906,-3.687064846,0.143186984,7.48151993,7.624706914
50,2,3,17,109,Illinois,McDonough County,27238,27079,26828,-159,-251,57,233,103,364,-46,-131,1,23,-115,-145,-114,-122,1,2,2968,2968,2968,8.64451741,13.50473964,-4.860222235,0.853321461,-5.379635298,-4.526313837
50,2,3,17,111,Illinois,McHenry County,310229,309770,311122,-459,1352,751,2901,688,2560,63,341,2,-17,-532,987,-530,970,8,41,1530,1530,1530,9.34462032,8.246200628,1.098419693,-0.054759926,3.179296883,3.124536957
50,2,3,17,113,Illinois,McLean County,170954,170870,170889,-84,19,466,1663,373,1474,93,189,14,172,-198,-381,-184,-209,7,39,10311,10311,10311,9.732004132,8.625961569,1.106042562,1.006557252,-2.229641355,-1.223084103
50,2,3,17,115,Illinois,Macon County,103998,103647,102432,-351,-1215,285,1191,375,1430,-90,-239,0,26,-256,-1002,-256,-976,-5,0,3859,3859,3859,11.5586741,13.87817293,-2.319498833,0.252330417,-9.72442607,-9.472095653
50,2,3,17,117,Illinois,Macoupin County,44967,44810,44406,-157,-404,94,385,156,674,-62,-289,0,1,-93,-122,-93,-121,-2,6,796,796,796,8.630738881,15.10939742,-6.478658537,0.022417504,-2.734935438,-2.712517934
50,2,3,17,119,Illinois,Madison County,265859,265498,264490,-361,-1008,685,2598,847,3461,-162,-863,0,23,-194,-220,-194,-197,-5,52,3786,3786,3786,9.803995562,13.06067307,-3.25667751,0.086794418,-0.830207476,-0.743413058
50,2,3,17,121,Illinois,Marion County,37729,37613,37390,-116,-223,118,422,153,527,-35,-105,0,3,-79,-128,-79,-125,-2,7,704,704,704,11.25288322,14.05277122,-2.799888004,0.0799968,-3.413196805,-3.333200005
50,2,3,17,123,Illinois,Marshall County,11742,11691,11663,-51,-28,21,109,36,173,-15,-64,0,0,-36,35,-36,35,0,1,241,241,241,9.334589364,14.81544917,-5.48085981,0,2.997345209,2.997345209
50,2,3,17,125,Illinois,Mason County,13086,13026,12881,-60,-145,38,141,56,193,-18,-52,0,0,-41,-95,-41,-95,-1,2,154,154,154,10.88508897,14.89944803,-4.014359054,0,-7.333925194,-7.333925194
50,2,3,17,127,Illinois,Massac County,14169,14125,13960,-44,-165,23,150,42,228,-19,-78,0,0,-24,-87,-24,-87,-1,0,274,274,274,10.68185864,16.23642514,-5.554566495,0,-6.195478013,-6.195478013
50,2,3,17,129,Illinois,Menard County,12297,12265,12164,-32,-101,24,123,33,145,-9,-22,0,1,-22,-82,-22,-81,-1,2,129,129,129,10.06999877,11.87113676,-1.801137992,0.081869909,-6.713332515,-6.631462606
50,2,3,17,131,Illinois,Mercer County,15699,15633,15582,-66,-51,38,124,45,202,-7,-78,0,0,-58,25,-58,25,-1,2,159,159,159,7.944898286,12.9424956,-4.997597309,0,1.601794009,1.601794009
50,2,3,17,133,Illinois,Monroe County,34962,34898,34932,-64,34,60,325,113,393,-53,-68,0,4,-10,93,-10,97,-1,5,296,296,296,9.308320206,11.2559072,-1.947586997,0.114563941,2.663611628,2.778175569
50,2,3,17,135,Illinois,Montgomery County,28288,28157,28084,-131,-73,72,254,138,413,-66,-159,0,1,-63,80,-63,81,-2,5,2383,2383,2383,9.03255632,14.68679433,-5.654238011,0.035561245,2.844899628,2.880460874
50,2,3,17,137,Illinois,Morgan County,32915,32798,32606,-117,-192,84,338,139,461,-55,-123,0,10,-61,-84,-61,-74,-1,5,3143,3143,3143,10.33575928,14.09699713,-3.761237845,0.305791695,-2.568650235,-2.262858541
50,2,3,17,139,Illinois,Moultrie County,14526,14486,14510,-40,24,48,166,56,209,-8,-43,0,1,-31,66,-31,67,-1,0,348,348,348,11.44985515,14.41578149,-2.965926335,0.068975031,4.552352049,4.62132708
50,2,3,17,141,Illinois,Ogle County,51788,51678,51449,-110,-229,142,513,154,594,-12,-81,0,4,-96,-160,-96,-156,-2,8,486,486,486,9.948897961,11.51977659,-1.570878625,0.077574253,-3.102970124,-3.025395871
50,2,3,17,143,Illinois,Peoria County,181830,181225,179432,-605,-1793,549,2249,539,2124,10,125,0,101,-614,-2021,-614,-1920,-1,2,4741,4741,4741,12.47168362,11.77850423,0.693179392,0.560088949,-11.20732441,-10.64723546
50,2,3,17,145,Illinois,Perry County,20945,20880,20985,-65,105,49,176,60,276,-11,-100,0,2,-53,202,-53,204,-1,1,2435,2435,2435,8.407978025,13.18523827,-4.777260241,0.095545205,9.650065687,9.745610892
50,2,3,17,147,Illinois,Piatt County,16673,16654,16753,-19,99,45,174,57,196,-12,-22,0,0,-6,120,-6,120,-1,1,59,59,59,10.41697848,11.73406771,-1.317089233,0,7.184123088,7.184123088
50,2,3,17,149,Illinois,Pike County,14739,14633,14618,-106,-15,43,169,63,229,-20,-60,0,1,-84,42,-84,43,-2,2,389,389,389,11.55516051,15.65758436,-4.102423849,0.068373731,2.871696694,2.940070425
50,2,3,17,151,Illinois,Pope County,3763,3744,3779,-19,35,3,37,15,37,-12,0,0,0,-6,34,-6,34,-1,1,207,207,207,9.836501396,9.836501396,0,0,9.038947229,9.038947229
50,2,3,17,153,Illinois,Pulaski County,5193,5161,5065,-32,-96,16,49,26,78,-10,-29,0,1,-22,-68,-22,-67,0,0,17,17,17,9.583414825,15.25523176,-5.671816937,0.195579894,-13.29943282,-13.10385292
50,2,3,17,155,Illinois,Putnam County,5637,5635,5566,-2,-69,13,40,14,74,-1,-34,0,0,-1,-35,-1,-35,0,0,1,1,1,7.142219445,13.21310597,-6.070886528,0,-6.249442014,-6.249442014
50,2,3,17,157,Illinois,Randolph County,30163,30055,30142,-108,87,75,283,120,419,-45,-136,0,6,-62,215,-62,221,-1,2,4022,4022,4022,9.402461917,13.92095952,-4.5184976,0.199345482,7.143213117,7.342558599
50,2,3,17,159,Illinois,Richland County,15813,15803,15796,-10,-7,45,168,59,212,-14,-44,0,1,5,33,5,34,-1,3,330,330,330,10.63324789,13.41814614,-2.784898256,0.063293142,2.088673692,2.151966834
50,2,3,17,161,Illinois,Rock Island County,144672,144267,142909,-405,-1358,377,1548,469,1768,-92,-220,1,99,-308,-1243,-307,-1144,-6,6,4560,4560,4560,10.7808452,12.31300666,-1.532161462,0.689472658,-8.65671226,-7.967239602
50,2,3,17,163,Illinois,St. Clair County,257400,256789,254796,-611,-1993,713,2864,815,3146,-102,-282,-7,46,-503,-1787,-510,-1741,1,30,4231,4231,4231,11.19657535,12.29903144,-1.102456092,0.179833263,-6.986131337,-6.806298074
50,2,3,17,165,Illinois,Saline County,23768,23634,23320,-134,-314,57,281,117,402,-60,-121,0,1,-73,-194,-73,-193,-1,0,852,852,852,11.96916131,17.1231418,-5.153980492,0.04259488,-8.263406739,-8.220811858
50,2,3,17,167,Illinois,Sangamon County,196343,196012,194734,-331,-1278,513,1980,584,2462,-71,-482,-2,86,-254,-911,-256,-825,-4,29,3846,3846,3846,10.13446075,12.60153655,-2.467075799,0.440183649,-4.662875628,-4.222691979
50,2,3,17,169,Illinois,Schuyler County,6902,6875,6843,-27,-32,15,64,17,94,-2,-30,0,9,-25,-11,-25,-2,0,0,452,452,452,9.33080624,13.70462167,-4.373815425,1.312144628,-1.603732322,-0.291587695
50,2,3,17,171,Illinois,Scott County,4949,4927,4836,-22,-91,9,39,27,64,-18,-25,0,2,-3,-68,-3,-66,-1,0,29,29,29,7.989347537,13.11072416,-5.121376626,0.40971013,-13.93014442,-13.52043429
50,2,3,17,173,Illinois,Shelby County,20990,20900,20789,-90,-111,48,195,65,313,-17,-118,0,0,-71,4,-71,4,-2,3,141,141,141,9.354985728,15.01595145,-5.660965722,0,0.191897143,0.191897143
50,2,3,17,175,Illinois,Stark County,5400,5391,5294,-9,-97,14,57,14,79,0,-22,0,1,-9,-75,-9,-74,0,-1,84,84,84,10.66916238,14.7870847,-4.117922321,0.187178287,-14.03837155,-13.85119326
50,2,3,17,177,Illinois,Stephenson County,44630,44457,44021,-173,-436,111,449,170,651,-59,-202,0,3,-109,-240,-109,-237,-5,3,769,769,769,10.14941567,14.7155225,-4.566106829,0.067813468,-5.42507742,-5.357263953
50,2,3,17,179,Illinois,Tazewell County,131343,131018,130413,-325,-605,370,1245,465,1645,-95,-400,0,20,-226,-244,-226,-224,-4,19,2426,2426,2426,9.524501685,12.58458255,-3.060080863,0.153004043,-1.866649326,-1.713645283
50,2,3,17,181,Illinois,Union County,17244,17179,16923,-65,-256,36,157,64,260,-28,-103,0,1,-35,-153,-35,-152,-2,-1,555,555,555,9.207671104,15.24837253,-6.040701425,0.058647587,-8.973080758,-8.914433171
50,2,3,17,183,Illinois,Vermilion County,74188,73883,73095,-305,-788,187,863,292,1093,-105,-230,0,12,-198,-571,-198,-559,-2,1,2701,2701,2701,11.74325409,14.87297419,-3.129720094,0.163289744,-7.769870321,-7.606580577
50,2,3,17,185,Illinois,Wabash County,11361,11316,11202,-45,-114,37,104,35,158,2,-54,0,1,-47,-62,-47,-61,0,1,68,68,68,9.237054801,14.03321787,-4.79616307,0.088817835,-5.506705747,-5.417887912
50,2,3,17,187,Illinois,Warren County,16835,16777,16531,-58,-246,38,160,58,209,-20,-49,0,8,-37,-206,-37,-198,-1,1,950,950,950,9.607301549,12.54953765,-2.942236099,0.480365078,-12.36940074,-11.88903567
50,2,3,17,189,Illinois,Washington County,13761,13711,13655,-50,-56,27,145,36,160,-9,-15,0,0,-41,-43,-41,-43,0,2,206,206,206,10.59709128,11.6933421,-1.096250822,0,-3.14258569,-3.14258569
50,2,3,17,191,Illinois,Wayne County,16179,16121,15963,-58,-158,46,186,65,231,-19,-45,-1,0,-37,-112,-38,-112,-1,-1,56,56,56,11.59456427,14.39970079,-2.805136517,0,-6.981673108,-6.981673108
50,2,3,17,193,Illinois,White County,13877,13808,13784,-69,-24,35,128,69,244,-34,-116,0,0,-34,91,-34,91,-1,1,370,370,370,9.278051609,17.68628588,-8.408234271,0,6.596114816,6.596114816
50,2,3,17,195,Illinois,Whiteside County,55691,55509,55305,-182,-204,132,598,185,770,-53,-172,0,12,-126,-51,-126,-39,-3,7,951,951,951,10.79286011,13.89716101,-3.104300901,0.216579133,-0.920461314,-0.703882181
50,2,3,17,197,Illinois,Will County,696355,695903,697252,-452,1349,1808,6866,1401,5915,407,951,2,77,-892,202,-890,279,31,119,8515,8515,8515,9.856763964,8.491517455,1.365246509,0.110540464,0.289989269,0.400529733
50,2,3,17,199,Illinois,Williamson County,67153,67094,66879,-59,-215,170,683,201,876,-31,-193,0,19,-25,-51,-25,-32,-3,10,1933,1933,1933,10.19608429,13.07726184,-2.881177551,0.283639241,-0.761347436,-0.477708195
50,2,3,17,201,Illinois,Winnebago County,285350,284858,283119,-492,-1739,876,3257,895,3426,-19,-169,-1,108,-468,-1716,-469,-1608,-4,38,4564,4564,4564,11.46877426,12.06386878,-0.59509452,0.38029709,-6.0424982,-5.66220111
50,2,3,17,203,Illinois,Woodford County,38467,38395,38225,-72,-170,102,418,114,452,-12,-34,0,-1,-60,-139,-60,-140,0,4,932,932,932,10.9109893,11.79848604,-0.887496737,-0.026102845,-3.628295484,-3.654398329
40,2,3,18,0,Indiana,Indiana,6785528,6785644,6805985,116,20341,19219,77598,19664,76906,-445,692,238,4756,335,14280,573,19036,-12,613,181555,181555,181555,11.41849884,11.31667146,0.101827382,0.699842528,2.101293377,2.801135905
50,2,3,18,1,Indiana,Adams County,35809,35826,35961,17,135,169,647,102,353,67,294,0,0,-50,-164,-50,-164,0,5,346,346,346,18.0255478,9.834649728,8.190898074,0,-4.569072395,-4.569072395
50,2,3,18,3,Indiana,Allen County,385410,385892,388608,482,2716,1275,5090,1032,3989,243,1101,8,245,226,1299,234,1544,5,71,5905,5905,5905,13.14396385,10.30083925,2.843124597,0.632666236,3.354422208,3.987088444
50,2,3,18,5,Indiana,Bartholomew County,82208,82157,82475,-51,318,259,975,241,898,18,77,4,198,-73,32,-69,230,0,11,935,935,935,11.84459886,10.90917926,0.935419603,2.405364692,0.388745809,2.794110501
50,2,3,18,7,Indiana,Benton County,8719,8712,8714,-7,2,31,103,27,93,4,10,0,0,-10,-10,-10,-10,-1,2,67,67,67,11.82141628,10.67370596,1.147710318,0,-1.147710318,-1.147710318
50,2,3,18,9,Indiana,Blackford County,12112,12098,12091,-14,-7,18,130,38,162,-20,-32,0,4,7,21,7,25,-1,0,152,152,152,10.74868742,13.39451817,-2.64583075,0.330728844,1.736326429,2.067055273
50,2,3,18,11,Indiana,Boone County,70812,71169,73052,357,1883,210,828,147,659,63,169,0,30,292,1699,292,1729,2,-15,531,531,531,11.48237774,9.138752332,2.343625408,0.416028179,23.56106254,23.97709072
50,2,3,18,13,Indiana,Brown County,15475,15470,15552,-5,82,19,94,50,194,-31,-100,0,-1,27,186,27,185,-1,-3,143,143,143,6.060215331,12.50725292,-6.447037586,-0.064470376,11.99148991,11.92701954
50,2,3,18,15,Indiana,Carroll County,20306,20307,20444,1,137,47,212,52,209,-5,3,1,8,6,126,7,134,-1,0,81,81,81,10.40465265,10.257417,0.147235651,0.392628402,6.183897328,6.576525729
50,2,3,18,17,Indiana,Cass County,37870,37771,37563,-99,-208,106,440,133,479,-27,-39,-1,55,-71,-227,-72,-172,0,3,991,991,991,11.68131256,12.71670162,-1.035389067,1.460164069,-6.026495341,-4.566331271
50,2,3,18,19,Indiana,Clark County,121093,121282,122738,189,1456,341,1359,383,1432,-42,-73,-1,32,230,1494,229,1526,2,3,1256,1256,1256,11.13843128,11.73674289,-0.598311614,0.262273584,12.24489796,12.50717154
50,2,3,18,21,Indiana,Clay County,26466,26432,26410,-34,-22,69,307,82,341,-13,-34,0,1,-21,5,-21,6,0,6,294,294,294,11.61954506,12.90640021,-1.286855153,0.037848681,0.189243405,0.227092086
50,2,3,18,23,Indiana,Clinton County,33190,33151,33065,-39,-86,115,439,109,374,6,65,-1,0,-45,-156,-46,-156,1,5,785,785,785,13.25963513,11.29636342,1.963271717,0,-4.71185212,-4.71185212
50,2,3,18,25,Indiana,Crawford County,10526,10540,10514,14,-26,41,114,38,150,3,-36,0,0,11,10,11,10,0,0,31,31,31,10.8292961,14.24907381,-3.419777714,0,0.949938254,0.949938254
50,2,3,18,27,Indiana,Daviess County,33381,33391,33397,10,6,146,554,92,399,54,155,0,6,-44,-161,-44,-155,0,6,496,496,496,16.58980655,11.94825418,4.641552375,0.179672995,-4.82122537,-4.641552375
50,2,3,18,29,Indiana,Dearborn County,50679,50726,50816,47,90,123,494,129,588,-6,-94,0,3,54,175,54,178,-1,6,491,491,491,9.729963956,11.58141459,-1.851450631,0.05908885,3.44684958,3.505938429
50,2,3,18,31,Indiana,Decatur County,26472,26477,26320,5,-157,60,299,75,352,-15,-53,0,10,20,-117,20,-107,0,3,301,301,301,11.32640112,13.33409095,-2.007689831,0.378809402,-4.432070004,-4.053260602
50,2,3,18,33,Indiana,DeKalb County,43265,43274,43333,9,59,125,519,116,510,9,9,0,2,0,39,0,41,0,9,490,490,490,11.98517441,11.77733901,0.207835394,0.046185643,0.900620042,0.946805686
50,2,3,18,35,Indiana,Delaware County,111903,111669,111871,-234,202,255,1003,433,1502,-178,-499,-2,35,-51,654,-53,689,-3,12,8316,8316,8316,8.973785452,13.43831082,-4.464525365,0.313143062,5.85130178,6.164444842
50,2,3,18,37,Indiana,Dubois County,43637,43604,43549,-33,-55,125,503,122,499,3,4,1,20,-37,-85,-36,-65,0,6,842,842,842,11.54291878,11.45112618,0.091792595,0.458962973,-1.950592636,-1.491629663
50,2,3,18,39,Indiana,Elkhart County,207047,206842,206921,-205,79,730,2927,552,1999,178,928,4,90,-393,-970,-389,-880,6,31,3489,3489,3489,14.14819595,9.662536283,4.485659665,0.435031649,-4.688674434,-4.253642786
50,2,3,18,41,Indiana,Fayette County,23398,23333,23360,-65,27,58,225,93,357,-35,-132,0,3,-29,155,-29,158,-1,1,353,353,353,9.637418885,15.2913713,-5.653952413,0.128498919,6.639110788,6.767609706
50,2,3,18,43,Indiana,Floyd County,80484,80437,80454,-47,17,203,826,312,988,-109,-162,1,26,63,138,64,164,-2,15,1265,1265,1265,10.26782107,12.2816068,-2.013785731,0.323200179,1.715447104,2.038647283
50,2,3,18,45,Indiana,Fountain County,16479,16470,16427,-9,-43,53,170,80,268,-27,-98,0,2,18,51,18,53,0,2,134,134,134,10.33528893,16.29327902,-5.95799009,0.121591635,3.10058668,3.222178314
50,2,3,18,47,Indiana,Franklin County,22785,22767,22842,-18,75,56,248,64,277,-8,-29,0,8,-8,93,-8,101,-2,3,150,150,150,10.87504659,12.14672543,-1.271678835,0.350807955,4.078142472,4.428950427
50,2,3,18,49,Indiana,Fulton County,20480,20434,20386,-46,-48,43,230,76,253,-33,-23,0,2,-11,-30,-11,-28,-2,3,194,194,194,11.26898579,12.39588437,-1.126898579,0.097991181,-1.469867712,-1.371876531
50,2,3,18,51,Indiana,Gibson County,33011,33021,32924,10,-97,96,353,105,417,-9,-64,0,22,20,-62,20,-40,-1,7,614,614,614,10.70589127,12.64690272,-1.941011449,0.667222686,-1.880354841,-1.213132156
50,2,3,18,53,Indiana,Grant County,66674,66446,66263,-228,-183,172,718,265,959,-93,-241,1,9,-134,36,-133,45,-2,13,4825,4825,4825,10.82066778,14.45267465,-3.632006872,0.135635111,0.542540446,0.678175557
50,2,3,18,55,Indiana,Greene County,30803,30790,30786,-13,-4,78,314,126,475,-48,-161,0,10,38,144,38,154,-3,3,185,185,185,10.19877875,15.42808887,-5.229310121,0.324801871,4.67714694,5.001948811
50,2,3,18,57,Indiana,Hamilton County,347467,348868,356650,1401,7782,883,3572,568,2390,315,1182,9,232,1059,6402,1068,6634,18,-34,1737,1737,1737,10.12589332,6.77516378,3.350729535,0.657672802,18.14836758,18.80604039
50,2,3,18,59,Indiana,Hancock County,79840,80156,81789,316,1633,208,822,216,856,-8,-34,0,8,325,1678,325,1686,-1,-19,580,580,580,10.15159468,10.57149032,-0.419895644,0.098798975,20.723085,20.82188397
50,2,3,18,61,Indiana,Harrison County,39654,39652,39761,-2,109,104,378,129,488,-25,-110,0,4,25,212,25,216,-2,3,344,344,344,9.519851913,12.29017919,-2.770327276,0.100739174,5.339176205,5.439915379
50,2,3,18,63,Indiana,Hendricks County,174788,175528,179355,740,3827,401,1623,387,1473,14,150,5,79,716,3634,721,3713,5,-36,4004,4004,4004,9.14667651,8.30132748,0.845349031,0.445217156,20.47998918,20.92520634
50,2,3,18,65,Indiana,Henry County,48914,48885,48935,-29,50,97,441,152,733,-55,-292,0,0,28,339,28,339,-2,3,3573,3573,3573,9.016561031,14.98671028,-5.970149254,0,6.931097935,6.931097935
50,2,3,18,67,Indiana,Howard County,83658,83619,83687,-39,68,264,953,312,1250,-48,-297,4,23,10,332,14,355,-5,10,1196,1196,1196,11.39229914,14.94267988,-3.550380739,0.27494531,3.968775776,4.243721086
50,2,3,18,69,Indiana,Huntington County,36662,36599,36717,-63,118,103,378,123,490,-20,-112,-1,6,-41,221,-42,227,-1,3,1271,1271,1271,10.31152818,13.36679579,-3.055267609,0.163675051,6.028697692,6.192372743
50,2,3,18,71,Indiana,Jackson County,46428,46373,46067,-55,-306,140,603,156,592,-16,11,1,34,-40,-355,-39,-321,0,4,578,578,578,13.0463003,12.80830809,0.237992211,0.735612289,-7.680657724,-6.945045435
50,2,3,18,73,Indiana,Jasper County,32918,32906,33091,-12,185,99,336,92,415,7,-79,0,1,-18,261,-18,262,-1,2,836,836,836,10.18228101,12.57632923,-2.394048214,0.030304408,7.90945043,7.939754837
50,2,3,18,75,Indiana,Jay County,20478,20456,20248,-22,-208,67,266,70,257,-3,9,-1,-4,-17,-213,-18,-217,-1,0,199,199,199,13.06996855,12.62775157,0.442216981,-0.196540881,-10.46580189,-10.66234277
50,2,3,18,77,Indiana,Jefferson County,33147,33075,33141,-72,66,94,371,122,415,-28,-44,0,14,-44,91,-44,105,0,5,2045,2045,2045,11.20575088,12.53473481,-1.328983931,0.422858524,2.748580404,3.171438927
50,2,3,18,79,Indiana,Jennings County,27613,27564,27409,-49,-155,74,301,90,379,-16,-78,0,2,-32,-84,-32,-82,-1,5,243,243,243,10.95083041,13.78858713,-2.837756717,0.072762993,-3.056045695,-2.983282702
50,2,3,18,81,Indiana,Johnson County,161765,162180,164298,415,2118,439,1809,445,1674,-6,135,2,81,416,1899,418,1980,3,3,2314,2314,2314,11.08191057,10.25490232,0.827008252,0.496204951,11.63324941,12.12945436
50,2,3,18,83,Indiana,Knox County,36282,36244,35956,-38,-288,101,391,118,531,-17,-140,0,8,-20,-159,-20,-151,-1,3,1776,1776,1776,10.83102493,14.70914127,-3.878116343,0.221606648,-4.404432133,-4.182825485
50,2,3,18,85,Indiana,Kosciusko County,80240,80050,80106,-190,56,249,901,247,898,2,3,0,58,-191,-20,-191,38,-1,15,1520,1520,1520,11.25152976,11.21406629,0.037463473,0.724293814,-0.249756487,0.474537326
50,2,3,18,87,Indiana,LaGrange County,40446,40515,40524,69,9,179,732,73,337,106,395,0,6,-39,-394,-39,-388,2,2,291,291,291,18.06537593,8.316983181,9.748392749,0.148076852,-9.723713274,-9.575636422
50,2,3,18,89,Indiana,Lake County,498700,498597,498558,-103,-39,1338,5436,1651,6146,-313,-710,-2,102,224,472,222,574,-12,97,6364,6364,6364,10.90301909,12.32707052,-1.424051426,0.204582036,0.946693343,1.151275379
50,2,3,18,91,Indiana,LaPorte County,112417,112222,112390,-195,168,276,1137,374,1464,-98,-327,0,23,-93,456,-93,479,-4,16,6488,6488,6488,10.12412516,13.03581287,-2.91168771,0.204797607,4.060335156,4.265132762
50,2,3,18,93,Indiana,Lawrence County,45011,45022,45070,11,48,138,482,166,673,-28,-191,0,4,42,230,42,234,-3,5,541,541,541,10.70017316,14.94028327,-4.24011011,0.088798118,5.105891755,5.194689873
50,2,3,18,95,Indiana,Madison County,130129,130065,130782,-64,717,320,1365,478,1771,-158,-406,0,31,99,1085,99,1116,-5,7,6119,6119,6119,10.4659053,13.57884124,-3.112935936,0.237687227,8.319052931,8.556740158
50,2,3,18,97,Indiana,Marion County,977203,976770,971102,-433,-5668,3299,13434,2413,9904,886,3530,142,1608,-1501,-10836,-1359,-9228,40,30,18193,18193,18193,13.79351415,10.16904602,3.624468138,1.651032511,-11.12598774,-9.474955233
50,2,3,18,99,Indiana,Marshall County,46095,46018,46121,-77,103,108,499,153,528,-45,-29,3,6,-34,123,-31,129,-1,3,580,580,580,10.83146116,11.46094488,-0.629483715,0.13023801,2.669879204,2.800117214
50,2,3,18,101,Indiana,Martin County,9812,9786,9780,-26,-6,29,113,33,125,-4,-12,0,0,-21,3,-21,3,-1,3,85,85,85,11.55064909,12.77726669,-1.226617602,0,0.306654401,0.306654401
50,2,3,18,103,Indiana,Miami County,35962,35924,36081,-38,157,99,370,103,418,-4,-48,0,10,-34,194,-34,204,0,1,3352,3352,3352,10.27706409,11.61030484,-1.333240747,0.277758489,5.388514687,5.666273176
50,2,3,18,105,Indiana,Monroe County,139718,139517,139875,-201,358,256,1045,279,1191,-23,-146,16,314,-200,155,-184,469,6,35,13948,13948,13948,7.480529149,8.52565571,-1.045126561,2.247737945,1.10955217,3.357290116
50,2,3,18,107,Indiana,Montgomery County,37936,37932,38063,-4,131,105,434,121,501,-16,-67,0,8,13,185,13,193,-1,5,1074,1074,1074,11.42180407,13.18507797,-1.7632739,0.210540167,4.868741365,5.079281532
50,2,3,18,109,Indiana,Morgan County,71780,71802,72206,22,404,172,738,213,876,-41,-138,0,14,65,525,65,539,-2,3,542,542,542,10.24943059,12.16599078,-1.916560191,0.194433643,7.291261597,7.485695239
50,2,3,18,111,Indiana,Newton County,13830,13796,13808,-34,12,32,141,45,191,-13,-50,0,9,-21,51,-21,60,0,2,119,119,119,10.21591074,13.83857412,-3.622663382,0.652079409,3.69511665,4.347196059
50,2,3,18,113,Indiana,Noble County,47457,47379,47227,-78,-152,141,601,158,557,-17,44,2,11,-61,-215,-59,-204,-2,8,696,696,696,12.70532524,11.77515168,0.930173562,0.232543391,-4.545166269,-4.312622878
50,2,3,18,115,Indiana,Ohio County,5940,5930,5978,-10,48,9,50,20,96,-11,-46,0,2,2,93,2,95,-1,-1,35,35,35,8.397715821,16.12361438,-7.725898556,0.335908633,15.61975143,15.95566006
50,2,3,18,117,Indiana,Orange County,19867,19839,19830,-28,-9,45,235,66,289,-21,-54,0,7,-6,35,-6,42,-1,3,220,220,220,11.84804255,14.57057148,-2.722528927,0.352920416,1.764602082,2.117522499
50,2,3,18,119,Indiana,Owen County,21321,21298,21446,-23,148,53,206,72,297,-19,-91,0,1,-2,238,-2,239,-2,0,170,170,170,9.638779712,13.89668725,-4.257907543,0.046790193,11.13606588,11.18285607
50,2,3,18,121,Indiana,Parke County,16156,16154,16407,-2,253,43,164,39,207,4,-43,0,0,-5,298,-5,298,-1,-2,1460,1460,1460,10.07340069,12.71459722,-2.641196523,0,18.30410614,18.30410614
50,2,3,18,123,Indiana,Perry County,19170,19150,19316,-20,166,46,174,56,236,-10,-62,0,3,-10,226,-10,229,0,-1,1528,1528,1528,9.046950554,12.27057661,-3.223626059,0.155981906,11.75063693,11.90661883
50,2,3,18,125,Indiana,Pike County,12250,12233,12144,-17,-89,33,123,48,184,-15,-61,0,0,0,-31,0,-31,-2,3,161,161,161,10.09147967,15.09619724,-5.004717562,0,-2.543381056,-2.543381056
50,2,3,18,127,Indiana,Porter County,173215,173256,174243,41,987,378,1581,458,1961,-80,-380,0,21,125,1337,125,1358,-4,9,3338,3338,3338,9.099306761,11.28636341,-2.187056653,0.120863657,7.694986173,7.81584983
50,2,3,18,129,Indiana,Posey County,25222,25161,25116,-61,-45,52,257,81,296,-29,-39,0,-1,-30,-8,-30,-9,-2,3,180,180,180,10.22336257,11.77476779,-1.551405215,-0.039779621,-0.318236967,-0.358016588
50,2,3,18,131,Indiana,Pulaski County,12514,12488,12339,-26,-149,23,137,55,193,-32,-56,0,2,6,-95,6,-93,0,0,173,173,173,11.03637169,15.54758932,-4.511217626,0.161114915,-7.652958473,-7.491843557
50,2,3,18,133,Indiana,Putnam County,36726,36666,36979,-60,313,82,357,112,455,-30,-98,0,21,-30,392,-30,413,0,-2,4632,4632,4632,9.69515921,12.35657546,-2.661416254,0.570303483,10.64566502,11.2159685
50,2,3,18,135,Indiana,Randolph County,24502,24375,24387,-127,12,49,247,92,332,-43,-85,0,9,-84,87,-84,96,0,1,288,288,288,10.13083959,13.6171609,-3.486321316,0.369139904,3.568352406,3.93749231
50,2,3,18,137,Indiana,Ripley County,28995,28980,29081,-15,101,98,345,89,319,9,26,-2,1,-22,70,-24,71,0,4,406,406,406,11.88405298,10.98844319,0.89560979,0.03444653,2.411257126,2.445703657
50,2,3,18,139,Indiana,Rush County,16752,16744,16672,-8,-72,55,192,74,226,-19,-34,0,2,12,-43,12,-41,-1,3,143,143,143,11.49150108,13.52645439,-2.034953316,0.119703136,-2.573617429,-2.453914293
50,2,3,18,141,Indiana,St. Joseph County,272912,272549,272212,-363,-337,840,3291,818,3170,22,121,4,238,-390,-748,-386,-510,1,52,11445,11445,11445,12.08236272,11.63813122,0.444231507,0.873777675,-2.746158407,-1.872380732
50,2,3,18,143,Indiana,Scott County,24384,24336,24355,-48,19,50,273,94,393,-44,-120,0,2,-3,134,-3,136,-1,3,285,285,285,11.2135713,16.14261363,-4.929042328,0.082150706,5.504097266,5.586247972
50,2,3,18,145,Indiana,Shelby County,45055,45026,45039,-29,13,113,466,154,549,-41,-83,0,19,14,68,14,87,-2,9,611,611,611,10.34808194,12.19119525,-1.843113307,0.421917504,1.510020541,1.931938045
50,2,3,18,147,Indiana,Spencer County,19810,19820,19798,10,-22,53,204,48,266,5,-62,0,4,7,33,7,37,-2,3,295,295,295,10.29834924,13.42823969,-3.129890454,0.201928416,1.665909435,1.867837852
50,2,3,18,149,Indiana,Starke County,23371,23356,23372,-15,16,67,251,102,326,-35,-75,0,2,22,87,22,89,-2,2,15,15,15,10.74302346,13.95309022,-3.210066769,0.085601781,3.723677453,3.809279233
50,2,3,18,151,Indiana,Steuben County,34435,34440,34632,5,192,104,343,108,423,-4,-80,1,7,11,262,12,269,-3,3,1232,1232,1232,9.931665509,12.24808895,-2.316423442,0.202687051,7.586286773,7.788973824
50,2,3,18,153,Indiana,Sullivan County,20817,20803,20758,-14,-45,52,193,64,259,-12,-66,0,1,-1,17,-1,18,-1,3,2241,2241,2241,9.287553235,12.46360771,-3.176054474,0.048122038,0.818074637,0.866196675
50,2,3,18,155,Indiana,Switzerland County,9737,9724,9790,-13,66,33,103,25,127,8,-24,0,4,-21,86,-21,90,0,0,39,39,39,10.55652352,13.01629599,-2.459772471,0.409962079,8.814184688,9.224146766
50,2,3,18,157,Indiana,Tippecanoe County,186251,186247,187076,-4,829,513,1949,375,1467,138,482,36,649,-190,-349,-154,300,12,47,15528,15528,15528,10.44136043,7.859146101,2.582214329,3.476881949,-1.869694608,1.607187342
50,2,3,18,159,Indiana,Tipton County,15359,15365,15372,6,7,27,150,49,198,-22,-48,2,8,28,44,30,52,-2,3,174,174,174,9.760223835,12.88349546,-3.123271627,0.520545271,2.862998991,3.383544263
50,2,3,18,161,Indiana,Union County,7087,7090,7047,3,-43,27,89,18,95,9,-6,0,2,-5,-39,-5,-37,-1,0,45,45,45,12.59107307,13.43990946,-0.848836387,0.282945462,-5.517436514,-5.234491052
50,2,3,18,163,Indiana,Vanderburgh County,180136,180158,179987,22,-171,479,2114,632,2385,-153,-271,0,90,179,-23,179,67,-4,33,6692,6692,6692,11.73971595,13.24466534,-1.504949395,0.499798692,-0.127726332,0.37207236
50,2,3,18,165,Indiana,Vermillion County,15439,15388,15341,-51,-47,38,131,55,261,-17,-130,0,6,-33,75,-33,81,-1,2,171,171,171,8.526147938,16.98721078,-8.46106284,0.390510593,4.881382408,5.271893
50,2,3,18,167,Indiana,Vigo County,106153,106007,105994,-146,-13,276,1133,339,1368,-63,-235,0,69,-80,131,-80,200,-3,22,9398,9398,9398,10.68862883,12.9055995,-2.216970675,0.650940326,1.235843227,1.886783553
50,2,3,18,169,Indiana,Wabash County,30976,30888,30816,-88,-72,86,310,139,560,-53,-250,0,3,-33,174,-33,177,-2,1,1768,1768,1768,10.04797096,18.15117334,-8.103202386,0.097238429,5.63982886,5.737067289
50,2,3,18,171,Indiana,Warren County,8440,8413,8475,-27,62,16,78,29,92,-13,-14,0,2,-13,75,-13,77,-1,-1,74,74,74,9.23732828,10.89531028,-1.657981999,0.236854571,8.882046424,9.118900995
50,2,3,18,173,Indiana,Warrick County,63898,63966,64514,68,548,149,588,195,765,-46,-177,0,9,116,717,116,726,-2,-1,657,657,657,9.153175592,11.90846824,-2.755292653,0.140099626,11.16127024,11.30136986
50,2,3,18,175,Indiana,Washington County,28182,28220,28102,38,-118,78,320,83,367,-5,-47,0,2,42,-76,42,-74,1,3,209,209,209,11.36323284,13.03220766,-1.668974823,0.071020205,-2.698767799,-2.627747594
50,2,3,18,177,Indiana,Wayne County,66553,66455,66456,-98,1,180,762,261,997,-81,-235,2,36,-17,192,-15,228,-2,8,2627,2627,2627,11.46631957,15.00252048,-3.536200916,0.541715885,2.889151387,3.430867272
50,2,3,18,179,Indiana,Wells County,28180,28179,28197,-1,18,91,316,73,331,18,-15,0,2,-16,27,-16,29,-3,4,407,407,407,11.21044416,11.7425855,-0.532141337,0.070952178,0.957854406,1.028806584
50,2,3,18,181,Indiana,White County,24688,24636,24651,-52,15,67,294,105,319,-38,-25,0,18,-12,19,-12,37,-2,3,275,275,275,11.93012356,12.94458985,-1.014466289,0.730415728,0.77099438,1.501410108
50,2,3,18,183,Indiana,Whitley County,34191,34316,34430,125,114,76,379,75,398,1,-19,0,3,124,128,124,131,0,2,363,363,363,11.02609606,11.5788555,-0.552759433,0.087277805,3.723853024,3.811130829
40,2,4,19,0,Iowa,Iowa,3190369,3188669,3193079,-1700,4410,9233,35771,9005,35538,228,233,108,3078,-1994,833,-1886,3911,-42,266,91659,91659,91659,11.21040818,11.13738744,0.073020746,0.964625993,0.261057002,1.225682995
50,2,4,19,1,Iowa,Adair County,7496,7477,7541,-19,64,22,98,28,100,-6,-2,0,1,-12,67,-12,68,-1,-2,148,148,148,13.05100546,13.31735251,-0.26634705,0.133173525,8.922626182,9.055799707
50,2,4,19,3,Iowa,Adams County,3704,3697,3641,-7,-56,9,43,13,35,-4,8,0,0,-3,-65,-3,-65,0,1,68,68,68,11.71981466,9.539384028,2.180430635,0,-17.71599891,-17.71599891
50,2,4,19,5,Iowa,Allamakee County,14061,14067,13926,6,-141,62,173,45,227,17,-54,0,17,-10,-104,-10,-87,-1,0,191,191,191,12.36023292,16.2183403,-3.858107384,1.214589362,-7.430429036,-6.215839674
50,2,4,19,7,Iowa,Appanoose County,12317,12282,12257,-35,-25,28,134,44,215,-16,-81,0,0,-18,56,-18,56,-1,0,71,71,71,10.92139044,17.52312645,-6.601736012,0,4.564163169,4.564163169
50,2,4,19,9,Iowa,Audubon County,5674,5671,5635,-3,-36,14,55,17,85,-3,-30,0,0,1,-7,1,-7,-1,1,106,106,106,9.729347249,15.03626393,-5.306916681,0,-1.238280559,-1.238280559
50,2,4,19,11,Iowa,Benton County,25575,25536,25691,-39,155,64,255,62,298,2,-43,0,5,-39,194,-39,199,-2,-1,257,257,257,9.955687431,11.63448963,-1.678802194,0.195209558,7.574130829,7.769340387
50,2,4,19,13,Iowa,Black Hawk County,131144,130980,130368,-164,-612,427,1589,363,1525,64,64,2,180,-228,-866,-226,-686,-2,10,4115,4115,4115,12.16003184,11.6702634,0.489768431,1.377473713,-6.627179087,-5.249705374
50,2,4,19,15,Iowa,Boone County,26715,26691,26723,-24,32,54,247,74,348,-20,-101,0,3,-2,127,-2,130,-2,3,679,679,679,9.248511626,13.03029168,-3.781780058,0.112330101,4.755307597,4.867637698
50,2,4,19,17,Iowa,Bremer County,24988,24974,25081,-14,107,63,244,93,296,-30,-52,0,16,17,140,17,156,-1,3,1494,1494,1494,9.749275797,11.82699031,-2.077714514,0.639296774,5.593846769,6.233143542
50,2,4,19,19,Iowa,Buchanan County,20565,20586,20657,21,71,72,266,66,233,6,33,0,5,16,29,16,34,-1,4,204,204,204,12.89915865,11.29888708,1.600271561,0.242465388,1.406299251,1.648764639
50,2,4,19,21,Iowa,Buena Vista County,20823,20776,20771,-47,-5,60,302,70,175,-10,127,0,72,-37,-205,-37,-133,0,1,809,809,809,14.53775243,8.424194286,6.113558139,3.465954221,-9.868341878,-6.402387657
50,2,4,19,23,Iowa,Butler County,14334,14311,14332,-23,21,36,152,48,206,-12,-54,0,1,-10,73,-10,74,-1,1,167,167,167,10.6134134,14.38396816,-3.77055476,0.069825088,5.097231435,5.167056523
50,2,4,19,25,Iowa,Calhoun County,9927,9886,9915,-41,29,25,92,36,118,-11,-26,0,5,-30,49,-30,54,0,1,713,713,713,9.292459977,11.91858997,-2.626129993,0.505024999,4.949244988,5.454269986
50,2,4,19,27,Iowa,Carroll County,20760,20702,20692,-58,-10,58,229,65,293,-7,-64,0,3,-50,50,-50,53,-1,1,377,377,377,11.06440547,14.15664106,-3.09223559,0.144948543,2.415809055,2.560757598
50,2,4,19,29,Iowa,Cass County,13127,13104,13050,-23,-54,39,114,70,217,-31,-103,1,6,7,44,8,50,0,-1,263,263,263,8.717595779,16.59402004,-7.876424256,0.458820831,3.36468609,3.823506921
50,2,4,19,31,Iowa,Cedar County,18505,18495,18410,-10,-85,47,175,47,232,0,-57,0,2,-9,-30,-9,-28,-1,0,269,269,269,9.483809782,12.57282211,-3.089012329,0.108386398,-1.625795963,-1.517409565
50,2,4,19,33,Iowa,Cerro Gordo County,43127,42965,42706,-162,-259,88,435,162,593,-74,-158,0,10,-85,-115,-85,-105,-3,4,1089,1089,1089,10.15512834,13.84365771,-3.688529374,0.233451226,-2.684689101,-2.451237875
50,2,4,19,35,Iowa,Cherokee County,11658,11632,11503,-26,-129,34,122,60,176,-26,-54,0,5,2,-80,2,-75,-2,0,346,346,346,10.54679058,15.21504214,-4.668251567,0.432245516,-6.915928247,-6.483682732
50,2,4,19,37,Iowa,Chickasaw County,12012,11970,11887,-42,-83,31,129,38,148,-7,-19,0,10,-35,-74,-35,-64,0,0,73,73,73,10.81443602,12.40725992,-1.592823909,0.838328373,-6.203629962,-5.365301589
50,2,4,19,39,Iowa,Clarke County,9748,9726,9785,-22,59,32,113,34,104,-2,9,0,23,-21,27,-21,50,1,0,149,149,149,11.58320947,10.66065297,0.922556507,2.357644406,2.76766952,5.125313926
50,2,4,19,41,Iowa,Clay County,16384,16333,16440,-51,107,36,169,54,197,-18,-28,0,6,-32,129,-32,135,-1,0,188,188,188,10.31336771,12.02209136,-1.708723644,0.366155067,7.872333933,8.238489
50,2,4,19,43,Iowa,Clayton County,17043,16996,16998,-47,2,47,185,54,249,-7,-64,0,4,-38,61,-38,65,-2,1,178,178,178,10.8842737,14.64964406,-3.765370359,0.235335648,3.588868624,3.824204271
50,2,4,19,45,Iowa,Clinton County,46460,46418,46463,-42,45,134,529,125,634,9,-105,0,6,-48,136,-48,142,-3,8,548,548,548,11.39091956,13.65187713,-2.260957569,0.129197575,2.928478376,3.057675951
50,2,4,19,47,Iowa,Crawford County,16525,16453,16193,-72,-260,40,213,53,188,-13,25,3,30,-62,-312,-59,-282,0,-3,427,427,427,13.04907186,11.51749066,1.531581204,1.837897445,-19.11413343,-17.27623599
50,2,4,19,49,Iowa,Dallas County,99678,100486,103796,808,3310,338,1209,162,672,176,537,1,73,621,2727,622,2800,10,-27,649,649,649,11.83657885,6.5791406,5.257438247,0.714698309,26.69838752,27.41308583
50,2,4,19,51,Iowa,Davis County,9110,9109,9138,-1,29,40,141,33,82,7,59,0,1,-7,-32,-7,-31,-1,1,66,66,66,15.45459528,8.987778813,6.466816463,0.109607059,-3.507425878,-3.39781882
50,2,4,19,53,Iowa,Decatur County,7645,7610,7659,-35,49,17,76,27,95,-10,-19,0,5,-25,65,-25,70,0,-2,600,600,600,9.9548104,12.443513,-2.4887026,0.654921737,8.513982579,9.168904316
50,2,4,19,55,Iowa,Delaware County,17488,17458,17510,-30,52,48,189,45,222,3,-33,0,5,-32,79,-32,84,-1,1,196,196,196,10.80988332,12.69732327,-1.887439945,0.285975749,4.518416838,4.804392588
50,2,4,19,57,Iowa,Des Moines County,38910,38831,38491,-79,-340,121,418,111,514,10,-96,0,13,-86,-261,-86,-248,-3,4,551,551,551,10.81192933,13.29505186,-2.483122527,0.336256176,-6.750989369,-6.414733194
50,2,4,19,59,Iowa,Dickinson County,17703,17747,17851,44,104,37,163,63,212,-26,-49,0,8,72,147,72,155,-2,-2,149,149,149,9.157817855,11.91078151,-2.75296365,0.449463453,8.258890949,8.708354402
50,2,4,19,61,Iowa,Dubuque County,99266,99229,98718,-37,-511,256,1112,241,1100,15,12,2,71,-51,-601,-49,-530,-3,7,4071,4071,4071,11.23533067,11.11408609,0.121244576,0.717363739,-6.072332493,-5.354968754
50,2,4,19,63,Iowa,Emmet County,9388,9332,9321,-56,-11,21,98,43,143,-22,-45,0,3,-34,30,-34,33,0,1,415,415,415,10.50769313,15.33265427,-4.824961132,0.321664076,3.216640755,3.53830483
50,2,4,19,65,Iowa,Fayette County,19509,19399,19258,-110,-141,56,195,88,276,-32,-81,0,4,-77,-67,-77,-63,-1,3,779,779,779,10.08872908,14.27943193,-4.190702848,0.206948289,-3.466383837,-3.259435549
50,2,4,19,67,Iowa,Floyd County,15627,15552,15413,-75,-139,42,167,71,219,-29,-52,0,3,-46,-90,-46,-87,0,0,187,187,187,10.78637171,14.14500242,-3.358630712,0.193767157,-5.813014694,-5.619247538
50,2,4,19,69,Iowa,Franklin County,10019,9983,9952,-36,-31,36,135,44,138,-8,-3,0,1,-28,-31,-28,-30,0,2,149,149,149,13.54401806,13.84499624,-0.300978179,0.10032606,-3.110107851,-3.009781791
50,2,4,19,71,Iowa,Fremont County,6605,6560,6567,-45,7,19,55,25,90,-6,-35,0,1,-38,40,-38,41,-1,1,84,84,84,8.379675478,13.71219624,-5.332520759,0.152357736,6.094309439,6.246667175
50,2,4,19,73,Iowa,Greene County,8771,8746,8717,-25,-29,21,77,28,111,-7,-34,0,0,-17,3,-17,3,-1,2,63,63,63,8.818645135,12.71259234,-3.893947203,0,0.343583577,0.343583577
50,2,4,19,75,Iowa,Grundy County,12329,12312,12347,-17,35,25,128,43,146,-18,-18,0,0,2,53,2,53,-1,0,118,118,118,10.38160509,11.84151831,-1.459913216,0,4.298633359,4.298633359
50,2,4,19,77,Iowa,Guthrie County,10623,10612,10567,-11,-45,20,91,35,162,-15,-71,0,6,5,19,5,25,-1,1,121,121,121,8.593418008,15.29817272,-6.70475471,0.56659899,1.794230134,2.360829123
50,2,4,19,79,Iowa,Hamilton County,15039,15020,14887,-19,-133,43,172,38,208,5,-36,0,6,-23,-104,-23,-98,-1,1,171,171,171,11.50232387,13.90978701,-2.407463136,0.401243856,-6.954893503,-6.553649647
50,2,4,19,81,Iowa,Hancock County,10795,10757,10663,-38,-94,41,100,37,140,4,-40,0,5,-40,-61,-40,-56,-2,2,166,166,166,9.337068161,13.07189543,-3.734827264,0.466853408,-5.695611578,-5.22875817
50,2,4,19,83,Iowa,Hardin County,16878,16821,16708,-57,-113,44,129,53,252,-9,-123,0,13,-47,-5,-47,8,-1,2,730,730,730,7.69483134,15.03176355,-7.336932208,0.77544812,-0.298249277,0.477198843
50,2,4,19,85,Iowa,Harrison County,14582,14546,14669,-36,123,46,161,62,234,-16,-73,0,0,-19,197,-19,197,-1,-1,268,268,268,11.02173541,16.01916824,-4.997432826,0,13.48622283,13.48622283
50,2,4,19,87,Iowa,Henry County,20482,20412,20387,-70,-25,39,197,70,260,-31,-63,0,6,-38,31,-38,37,-1,1,1569,1569,1569,9.657099439,12.74541043,-3.088310988,0.294124856,1.519645089,1.813769945
50,2,4,19,89,Iowa,Howard County,9469,9487,9478,18,-9,35,120,26,130,9,-10,0,0,9,1,9,1,0,0,177,177,177,12.65489059,13.7094648,-1.054574216,0,0.105457422,0.105457422
50,2,4,19,91,Iowa,Humboldt County,9597,9595,9634,-2,39,29,111,26,131,3,-20,0,3,-4,55,-4,58,-1,1,82,82,82,11.54506215,13.62525352,-2.080191378,0.312028707,5.720526288,6.032554995
50,2,4,19,93,Iowa,Ida County,7005,7007,6956,2,-51,20,68,31,117,-11,-49,0,1,13,-1,13,0,0,-2,93,93,93,9.740027215,16.75857624,-7.018549022,0.143235694,-0.143235694,0
50,2,4,19,95,Iowa,Iowa County,16662,16679,16568,17,-111,59,142,53,223,6,-81,0,-1,12,-31,12,-32,-1,2,262,262,262,8.542124101,13.41474419,-4.872620086,-0.060155804,-1.864829909,-1.924985713
50,2,4,19,97,Iowa,Jackson County,19485,19437,19368,-48,-69,53,198,64,265,-11,-67,0,0,-36,-2,-36,-2,-1,0,159,159,159,10.20487051,13.65803376,-3.453163252,0,-0.1030795,-0.1030795
50,2,4,19,99,Iowa,Jasper County,37813,37802,37764,-11,-38,112,370,114,489,-2,-119,0,7,-8,68,-8,75,-1,6,1774,1774,1774,9.792763942,12.94232856,-3.149564619,0.185268507,1.799751211,1.985019718
50,2,4,19,101,Iowa,Jefferson County,15663,15659,15647,-4,-12,32,144,50,221,-18,-77,2,58,15,6,17,64,-3,1,1325,1325,1325,9.19951447,14.11869929,-4.919184821,3.705359995,0.383313103,4.088673098
50,2,4,19,103,Iowa,Johnson County,152854,152984,154748,130,1764,434,1640,203,979,231,661,21,565,-130,506,-109,1071,8,32,8210,8210,8210,10.65862504,6.362679214,4.295945823,3.672026309,3.288575774,6.960602082
50,2,4,19,105,Iowa,Jones County,20646,20647,20805,1,158,52,181,51,251,1,-70,1,6,1,222,2,228,-2,0,1142,1142,1142,8.732992377,12.11039274,-3.377400367,0.28949146,10.71118402,11.00067548
50,2,4,19,107,Iowa,Keokuk County,10033,9995,9914,-38,-81,26,97,38,141,-12,-44,0,3,-27,-41,-27,-38,1,1,102,102,102,9.744336732,14.16444824,-4.420111507,0.301371239,-4.118740268,-3.817369029
50,2,4,19,109,Iowa,Kossuth County,14828,14786,14529,-42,-257,36,156,54,185,-18,-29,0,3,-23,-228,-23,-225,-1,-3,185,185,185,10.64301552,12.62152482,-1.978509296,0.204673375,-15.55517653,-15.35050316
50,2,4,19,111,Iowa,Lee County,33555,33512,33215,-43,-297,86,328,121,468,-35,-140,0,0,-6,-162,-6,-162,-2,5,1197,1197,1197,9.831102852,14.02730529,-4.196202437,0,-4.855605677,-4.855605677
50,2,4,19,113,Iowa,Linn County,230299,230263,228939,-36,-1324,676,2615,578,2365,98,250,7,214,-141,-1803,-134,-1589,0,15,5026,5026,5026,11.38932322,10.30047779,1.088845432,0.93205169,-7.852753255,-6.920701565
50,2,4,19,115,Iowa,Louisa County,10837,10806,10749,-31,-57,24,110,32,108,-8,2,0,32,-24,-91,-24,-59,1,0,80,80,80,10.20644862,10.02087683,0.185571793,2.969148689,-8.443516585,-5.474367896
50,2,4,19,117,Iowa,Lucas County,8634,8615,8710,-19,95,26,100,33,104,-7,-4,0,0,-12,100,-12,100,0,-1,44,44,44,11.54401154,12.00577201,-0.461760462,0,11.54401154,11.54401154
50,2,4,19,119,Iowa,Lyon County,11934,11917,12011,-17,94,36,172,21,150,15,22,0,5,-31,66,-31,71,-1,1,139,139,139,14.37646272,12.53761284,1.838849883,0.417920428,5.516549649,5.934470077
50,2,4,19,121,Iowa,Madison County,16548,16626,16773,78,147,50,172,30,171,20,1,0,1,60,143,60,144,-2,2,111,111,111,10.29970957,10.23982754,0.059882032,0.059882032,8.563130633,8.623012665
50,2,4,19,123,Iowa,Mahaska County,22190,22148,21984,-42,-164,53,258,70,269,-17,-11,0,16,-25,-170,-25,-154,0,1,908,908,908,11.69219614,12.19070063,-0.498504487,0.725097435,-7.704160247,-6.979062812
50,2,4,19,125,Iowa,Marion County,33414,33377,33380,-37,3,95,339,107,369,-12,-30,0,-4,-24,35,-24,31,-1,2,1272,1272,1272,10.1562383,11.05502045,-0.89878215,-0.11983762,1.048579175,0.928741555
50,2,4,19,127,Iowa,Marshall County,40105,40059,39853,-46,-206,124,480,141,547,-17,-67,5,117,-34,-260,-29,-143,0,4,1190,1190,1190,12.01321454,13.69005907,-1.676844529,2.928221043,-6.507157874,-3.578936831
50,2,4,19,129,Iowa,Mills County,14484,14405,14465,-79,60,43,148,38,161,5,-13,0,3,-83,69,-83,72,-1,1,434,434,434,10.25285764,11.15344648,-0.900588847,0.207828195,4.780048493,4.987876689
50,2,4,19,131,Iowa,Mitchell County,10565,10582,10555,17,-27,35,115,38,137,-3,-22,0,4,20,-10,20,-6,0,1,174,174,174,10.88139282,12.96305058,-2.081657757,0.378483229,-0.946208071,-0.567724843
50,2,4,19,133,Iowa,Monona County,8751,8742,8574,-9,-168,26,83,42,187,-16,-104,0,0,8,-63,8,-63,-1,-1,166,166,166,9.586509587,21.5985216,-12.01201201,0,-7.276507277,-7.276507277
50,2,4,19,135,Iowa,Monroe County,7577,7582,7610,5,28,22,101,36,103,-14,-2,0,0,20,28,20,28,-1,2,64,64,64,13.29647183,13.5597683,-0.263296472,0,3.686150606,3.686150606
50,2,4,19,137,Iowa,Montgomery County,10330,10335,10322,5,-13,29,98,36,178,-7,-80,0,1,13,66,13,67,-1,0,177,177,177,9.488309048,17.23386745,-7.745558406,0.09681948,6.390085685,6.486905165
50,2,4,19,139,Iowa,Muscatine County,43235,43113,42688,-122,-425,103,459,129,457,-26,2,-2,31,-94,-458,-96,-427,0,0,503,503,503,10.699176,10.6525565,0.046619503,0.722602301,-10.67586625,-9.953263948
50,2,4,19,141,Iowa,O'Brien County,14182,14154,14015,-28,-139,49,159,51,235,-2,-76,0,0,-25,-64,-25,-64,-1,1,395,395,395,11.28900565,16.68500834,-5.396002698,0,-4.544002272,-4.544002272
50,2,4,19,143,Iowa,Osceola County,6192,6189,6159,-3,-30,21,58,31,82,-10,-24,0,2,7,-10,7,-8,0,2,101,101,101,9.394233884,13.28150308,-3.887269193,0.323939099,-1.619695497,-1.295756398
50,2,4,19,145,Iowa,Page County,15211,15180,15197,-31,17,19,141,49,222,-30,-81,1,12,1,84,2,96,-3,2,1485,1485,1485,9.283339369,14.61632156,-5.33298219,0.790071436,5.530500049,6.320571485
50,2,4,19,147,Iowa,Palo Alto County,8996,8961,8906,-35,-55,15,109,44,116,-29,-7,0,6,-6,-54,-6,-48,0,0,228,228,228,12.2012649,12.98483237,-0.783567471,0.671629261,-6.044663346,-5.373034085
50,2,4,19,149,Iowa,Plymouth County,25698,25681,25650,-17,-31,78,260,84,286,-6,-26,-1,8,-9,-15,-10,-7,-1,2,248,248,248,10.1303306,11.14336366,-1.01303306,0.31170248,-0.58444215,-0.27273967
50,2,4,19,151,Iowa,Pocahontas County,7078,7075,7074,-3,-1,21,80,21,98,0,-18,0,6,-2,10,-2,16,-1,1,92,92,92,11.30821966,13.85256909,-2.544349424,0.848116475,1.413527458,2.261643932
50,2,4,19,153,Iowa,Polk County,492401,492769,496844,368,4075,1563,6288,1173,4480,390,1808,44,579,-81,1626,-37,2205,15,62,8966,8966,8966,12.70799798,9.054044359,3.653953616,1.170154394,3.286133064,4.456287458
50,2,4,19,155,Iowa,Pottawattamie County,93667,93560,93304,-107,-256,260,1028,321,1193,-61,-165,1,67,-45,-176,-44,-109,-2,18,1877,1877,1877,11.00265434,12.76864458,-1.765990239,0.717099067,-1.883722921,-1.166623855
50,2,4,19,157,Iowa,Poweshiek County,18662,18643,18586,-19,-57,41,146,47,238,-6,-92,0,15,-12,16,-12,31,-1,4,1612,1612,1612,7.843347928,12.78573155,-4.942383626,0.805823417,0.859544978,1.665368396
50,2,4,19,159,Iowa,Ringgold County,4663,4639,4639,-24,0,18,33,30,69,-12,-36,0,0,-13,36,-13,36,1,0,132,132,132,7.113602069,14.87389524,-7.760293167,0,7.760293167,7.760293167
50,2,4,19,161,Iowa,Sac County,9814,9791,9752,-23,-39,19,102,26,141,-7,-39,0,0,-15,0,-15,0,-1,0,145,145,145,10.43852019,14.42971908,-3.991198895,0,0,0
50,2,4,19,163,Iowa,Scott County,174669,174488,174170,-181,-318,525,1959,478,1905,47,54,-1,112,-227,-516,-228,-404,0,32,3234,3234,3234,11.23737301,10.92761388,0.309759134,0.642463388,-2.95992061,-2.317457222
50,2,4,19,165,Iowa,Shelby County,11746,11699,11770,-47,71,23,124,60,156,-37,-32,0,1,-8,103,-8,104,-2,-1,179,179,179,10.56713111,13.29413269,-2.727001577,0.085218799,8.777536325,8.862755124
50,2,4,19,167,Iowa,Sioux County,35872,35869,35893,-3,24,119,481,74,339,45,142,2,22,-50,-142,-48,-120,0,2,2235,2235,2235,13.40542348,9.447897216,3.957526267,0.613137872,-3.957526267,-3.344388395
50,2,4,19,169,Iowa,Story County,98537,98615,99472,78,857,217,766,145,624,72,142,13,255,-10,442,3,697,3,18,10515,10515,10515,7.733975475,6.300262006,1.433713469,2.574626301,4.462685588,7.037311888
50,2,4,19,171,Iowa,Tama County,17135,17072,16867,-63,-205,38,203,64,246,-26,-43,1,16,-38,-177,-37,-161,0,-1,260,260,260,11.96263885,14.49659684,-2.533957983,0.942868087,-10.43047821,-9.487610124
50,2,4,19,173,Iowa,Taylor County,5896,5861,5868,-35,7,15,60,23,85,-8,-25,0,7,-26,24,-26,31,-1,1,31,31,31,10.23105124,14.49398926,-4.262938017,1.193622645,4.092420496,5.286043141
50,2,4,19,175,Iowa,Union County,12138,12097,12018,-41,-79,30,118,55,159,-25,-41,0,7,-16,-47,-16,-40,0,2,403,403,403,9.786439975,13.18681319,-3.400373212,0.580551524,-3.897988804,-3.31743728
50,2,4,19,177,Iowa,Van Buren County,7203,7204,7243,1,39,24,95,29,93,-5,2,0,0,7,35,7,35,-1,2,49,49,49,13.15151935,12.87464526,0.276874092,0,4.845296601,4.845296601
50,2,4,19,179,Iowa,Wapello County,35437,35341,35256,-96,-85,118,435,128,492,-10,-57,1,56,-87,-88,-86,-32,0,4,865,865,865,12.32346984,13.93826933,-1.614799496,1.58646968,-2.493023783,-0.906554103
50,2,4,19,181,Iowa,Warren County,52403,52548,53402,145,854,129,547,134,534,-5,13,0,4,150,843,150,847,0,-6,1375,1375,1375,10.3256253,10.08022652,0.245398773,0.075507315,15.91316659,15.9886739
50,2,4,19,183,Iowa,Washington County,22565,22511,22491,-54,-20,65,302,88,260,-23,42,2,23,-33,-87,-31,-64,0,2,262,262,262,13.42162571,11.555042,1.866583707,1.022176792,-3.866494822,-2.84431803
50,2,4,19,185,Iowa,Wayne County,6497,6509,6508,12,-1,30,85,19,102,11,-17,0,0,2,16,2,16,-1,0,80,80,80,13.05984482,15.67181378,-2.611968964,0,2.458323731,2.458323731
50,2,4,19,187,Iowa,Webster County,36999,36954,37147,-45,193,120,426,140,527,-20,-101,0,25,-24,266,-24,291,-1,3,2745,2745,2745,11.49782054,14.22382964,-2.726009096,0.674754727,7.179390292,7.854145018
50,2,4,19,189,Iowa,Winnebago County,10679,10650,10656,-29,6,24,104,39,144,-15,-40,0,5,-15,41,-15,46,1,0,480,480,480,9.762508214,13.51731907,-3.754810851,0.469351356,3.848681123,4.318032479
50,2,4,19,191,Iowa,Winneshiek County,20070,20031,19892,-39,-139,48,168,53,214,-5,-46,0,13,-33,-107,-33,-94,-1,1,1889,1889,1889,8.416201187,10.72063723,-2.304436039,0.651253663,-5.360318613,-4.70906495
50,2,4,19,193,Iowa,Woodbury County,105941,105829,105607,-112,-222,388,1376,337,1141,51,235,2,125,-168,-599,-166,-474,3,17,2496,2496,2496,13.01575891,10.79286404,2.222894871,1.182390889,-5.66601714,-4.483626251
50,2,4,19,195,Iowa,Worth County,7443,7425,7385,-18,-40,22,82,23,79,-1,3,0,0,-16,-43,-16,-43,-1,0,60,60,60,11.07359892,10.66846725,0.405131668,0,-5.806887238,-5.806887238
50,2,4,19,197,Iowa,Wright County,12943,12914,12785,-29,-129,46,155,37,204,9,-49,0,13,-37,-92,-37,-79,-1,-1,193,193,193,12.06272618,15.87610413,-3.813377952,1.011712518,-7.159811666,-6.148099148
40,2,4,20,0,Kansas,Kansas,2937880,2935880,2934582,-2000,-1298,8452,33670,7981,31407,471,2263,41,1355,-2511,-5241,-2470,-3886,-1,325,74847,74847,74847,11.47098814,10.70000964,0.770978502,0.461633173,-1.785549417,-1.323916244
50,2,4,20,1,Kansas,Allen County,12526,12537,12464,11,-73,41,121,30,196,11,-75,0,2,1,-2,1,0,-1,2,349,349,349,9.679612816,15.67937283,-5.99976001,0.1599936,-0.1599936,0
50,2,4,20,3,Kansas,Anderson County,7836,7850,7778,14,-72,24,75,23,122,1,-47,0,0,14,-28,14,-28,-1,3,71,71,71,9.598157154,15.6130023,-6.01484515,0,-3.583312004,-3.583312004
50,2,4,20,5,Kansas,Atchison County,16348,16305,16239,-43,-66,43,179,55,188,-12,-9,0,-1,-32,-59,-32,-60,1,3,1368,1368,1368,11.00049164,11.55358899,-0.553097345,-0.061455261,-3.625860374,-3.687315634
50,2,4,20,7,Kansas,Barber County,4228,4198,4110,-30,-88,10,43,15,64,-5,-21,0,1,-25,-66,-25,-65,0,-2,23,23,23,10.35146846,15.40683678,-5.05536832,0.240731825,-15.88830043,-15.64756861
50,2,4,20,9,Kansas,Barton County,25493,25419,25216,-74,-203,79,285,81,353,-2,-68,3,15,-75,-151,-72,-136,0,1,582,582,582,11.25703565,13.94292485,-2.685889207,0.59247556,-5.964253975,-5.371778414
50,2,4,20,11,Kansas,Bourbon County,14360,14333,14323,-27,-10,51,185,51,189,0,-4,0,3,-26,-11,-26,-8,-1,2,355,355,355,12.91178113,13.19095477,-0.279173646,0.209380235,-0.767727527,-0.558347292
50,2,4,20,13,Kansas,Brown County,9508,9473,9455,-35,-18,27,108,44,154,-17,-46,0,0,-18,26,-18,26,0,2,91,91,91,11.41166526,16.27218935,-4.860524091,0,2.747252747,2.747252747
50,2,4,20,15,Kansas,Butler County,67380,67401,67889,21,488,194,655,188,781,6,-126,1,3,13,608,14,611,1,3,2209,2209,2209,9.682903393,11.54556878,-1.862665385,0.044349176,8.988099638,9.032448814
50,2,4,20,17,Kansas,Chase County,2572,2564,2598,-8,34,1,25,7,23,-6,2,0,1,-1,33,-1,34,-1,-2,133,133,133,9.686168152,8.9112747,0.774893452,0.387446726,12.78574196,13.17318869
50,2,4,20,19,Kansas,Chautauqua County,3379,3386,3395,7,9,7,30,13,43,-6,-13,0,0,14,24,14,24,-1,-2,76,76,76,8.84825247,12.68249521,-3.834242737,0,7.078601976,7.078601976
50,2,4,20,21,Kansas,Cherokee County,19362,19275,19130,-87,-145,45,204,77,356,-32,-152,0,3,-54,3,-54,6,-1,1,141,141,141,10.62361672,18.5392527,-7.915635985,0.156229658,0.156229658,0.312459315
50,2,4,20,23,Kansas,Cheyenne County,2616,2620,2633,4,13,8,31,5,43,3,-12,0,-2,1,27,1,25,0,0,43,43,43,11.80277936,16.37159718,-4.568817818,-0.761469636,10.27984009,9.518370455
50,2,4,20,25,Kansas,Clark County,1991,1973,1977,-18,4,6,26,12,22,-6,4,0,-1,-11,1,-11,0,-1,0,52,52,52,13.16455696,11.13924051,2.025316456,-0.506329114,0.506329114,0
50,2,4,20,27,Kansas,Clay County,8117,8112,8077,-5,-35,10,80,23,116,-13,-36,0,1,10,-1,10,0,-2,1,112,112,112,9.883254061,14.33071839,-4.447464328,0.123540676,-0.123540676,0
50,2,4,20,29,Kansas,Cloud County,9032,8988,8928,-44,-60,28,100,41,138,-13,-38,0,2,-31,-25,-31,-23,0,1,491,491,491,11.16320607,15.40522438,-4.242018308,0.223264122,-2.790801518,-2.567537397
50,2,4,20,31,Kansas,Coffey County,8360,8370,8338,10,-32,24,90,22,125,2,-35,0,0,9,2,9,2,-1,1,115,115,115,10.77328226,14.96289203,-4.189609768,0,0.239406272,0.239406272
50,2,4,20,33,Kansas,Comanche County,1689,1681,1670,-8,-11,5,12,9,25,-4,-13,0,0,-3,2,-3,2,-1,0,58,58,58,7.162041182,14.92091913,-7.758877947,0,1.19367353,1.19367353
50,2,4,20,35,Kansas,Cowley County,34549,34498,34496,-51,-2,95,359,120,574,-25,-215,-2,5,-22,205,-24,210,-2,3,1895,1895,1895,10.40670203,16.63912804,-6.232426008,0.14494014,5.942545729,6.087485868
50,2,4,20,37,Kansas,Crawford County,38972,38930,39110,-42,180,100,411,117,466,-17,-55,0,25,-26,205,-26,230,1,5,1710,1710,1710,10.53305997,11.94259354,-1.409533573,0.640697078,5.253716043,5.894413122
50,2,4,20,39,Kansas,Decatur County,2764,2749,2751,-15,2,6,22,12,48,-6,-26,0,4,-8,25,-8,29,-1,-1,68,68,68,8,17.45454546,-9.454545455,1.454545455,9.090909091,10.54545455
50,2,4,20,41,Kansas,Dickinson County,18402,18353,18459,-49,106,47,193,73,249,-26,-56,0,1,-22,162,-22,163,-1,-1,264,264,264,10.48571118,13.52819733,-3.042486146,0.05433011,8.801477779,8.855807889
50,2,4,20,43,Kansas,Doniphan County,7510,7469,7471,-41,2,12,74,27,96,-15,-22,0,-2,-25,24,-25,22,-1,2,401,401,401,9.906291834,12.85140562,-2.945113788,-0.267737617,3.212851406,2.945113789
50,2,4,20,45,Kansas,Douglas County,118785,118814,119363,29,549,294,1009,190,854,104,155,0,83,-81,280,-81,363,6,31,8352,8352,8352,8.472690478,7.171137431,1.301553047,0.696960664,2.351192601,3.048153264
50,2,4,20,47,Kansas,Edwards County,2907,2898,2832,-9,-66,8,25,6,46,2,-21,0,0,-10,-45,-10,-45,-1,0,33,33,33,8.72600349,16.05584642,-7.329842932,0,-15.70680628,-15.70680628
50,2,4,20,49,Kansas,Elk County,2483,2475,2441,-8,-34,2,18,13,35,-11,-17,0,0,4,-16,4,-16,-1,-1,29,29,29,7.323026851,14.23921888,-6.916192026,0,-6.509357201,-6.509357201
50,2,4,20,51,Kansas,Ellis County,28934,28931,28790,-3,-141,77,252,67,289,10,-37,2,19,-16,-126,-14,-107,1,3,998,998,998,8.731657456,10.01368653,-1.282029071,0.658339253,-4.365828728,-3.707489475
50,2,4,20,53,Kansas,Ellsworth County,6376,6354,6336,-22,-18,15,48,27,71,-12,-23,0,3,-10,2,-10,5,0,0,988,988,988,7.56501182,11.18991332,-3.624901497,0.472813239,0.315208826,0.788022065
50,2,4,20,55,Kansas,Finney County,38470,38297,38107,-173,-190,127,550,71,250,56,300,1,54,-234,-544,-233,-490,4,0,550,550,550,14.39715198,6.544159992,7.85299199,1.413538558,-14.24009214,-12.82655358
50,2,4,20,57,Kansas,Ford County,34287,34206,34159,-81,-47,157,604,70,286,87,318,3,52,-174,-419,-171,-367,3,2,686,686,686,17.66986031,8.366854385,9.303005924,1.521246252,-12.25773422,-10.73648797
50,2,4,20,59,Kansas,Franklin County,25996,26028,25986,32,-42,80,241,59,334,21,-93,1,2,10,44,11,46,0,5,445,445,445,9.266735879,12.8426962,-3.575960318,0.076902372,1.691852194,1.768754566
50,2,4,20,61,Kansas,Geary County,36739,36747,35934,8,-813,219,878,72,228,147,650,0,-8,-142,-1428,-142,-1436,3,-27,895,895,895,24.16037204,6.273991827,17.88638021,-0.220140064,-39.29500144,-39.51514151
50,2,4,20,63,Kansas,Gove County,2718,2694,2755,-24,61,4,44,17,37,-13,7,0,0,-12,56,-12,56,1,-2,53,53,53,16.14975225,13.58047348,2.569278767,0,20.55423013,20.55423013
50,2,4,20,65,Kansas,Graham County,2415,2405,2400,-10,-5,5,17,6,33,-1,-16,0,1,-9,10,-9,11,0,0,35,35,35,7.075962539,13.73569199,-6.659729448,0.416233091,4.162330905,4.578563996
50,2,4,20,67,Kansas,Grant County,7352,7327,7324,-25,-3,23,93,12,52,11,41,0,4,-37,-49,-37,-45,1,1,75,75,75,12.69537916,7.098491571,5.596887585,0.546037813,-6.688963211,-6.142925398
50,2,4,20,69,Kansas,Gray County,5653,5633,5644,-20,11,18,76,17,68,1,8,0,4,-21,-2,-21,2,0,1,45,45,45,13.47876208,12.05994502,1.418817061,0.709408531,-0.354704265,0.354704265
50,2,4,20,71,Kansas,Greeley County,1284,1277,1304,-7,27,2,17,4,13,-2,4,0,0,-5,23,-5,23,0,0,24,24,24,13.17318869,10.07361488,3.099573809,0,17.8225494,17.8225494
50,2,4,20,73,Kansas,Greenwood County,6016,5972,5939,-44,-33,13,52,27,86,-14,-34,0,0,-30,1,-30,1,0,0,74,74,74,8.731424733,14.44043321,-5.70900848,0,0.167912014,0.167912014
50,2,4,20,75,Kansas,Hamilton County,2518,2494,2484,-24,-10,11,39,8,16,3,23,0,7,-28,-39,-28,-32,1,-1,0,0,0,15.66894335,6.428284452,9.240658899,2.812374448,-15.66894335,-12.8565689
50,2,4,20,77,Kansas,Harper County,5485,5461,5331,-24,-130,18,62,22,106,-4,-44,0,1,-20,-86,-20,-85,0,-1,116,116,116,11.48999259,19.64418088,-8.154188288,0.185322461,-15.93773165,-15.75240919
50,2,4,20,79,Kansas,Harvey County,34024,33942,33817,-82,-125,89,369,117,436,-28,-67,1,21,-53,-85,-52,-64,-2,6,1206,1206,1206,10.89154208,12.86913916,-1.977597072,0.619843858,-2.508891808,-1.889047949
50,2,4,20,81,Kansas,Haskell County,3780,3756,3668,-24,-88,15,65,14,26,1,39,1,5,-25,-130,-24,-125,-1,-2,17,17,17,17.51077586,7.004310345,10.50646552,1.346982759,-35.02155172,-33.67456897
50,2,4,20,83,Kansas,Hodgeman County,1723,1718,1710,-5,-8,0,15,13,35,-13,-20,0,3,8,8,8,11,0,1,8,8,8,8.751458576,20.42007001,-11.66861144,1.750291715,4.667444574,6.417736289
50,2,4,20,85,Kansas,Jackson County,13232,13230,13261,-2,31,34,170,31,155,3,15,0,2,-4,10,-4,12,-1,4,111,111,111,12.83454758,11.7020875,1.132460081,0.150994677,0.754973387,0.905968065
50,2,4,20,87,Kansas,Jefferson County,18368,18300,18411,-68,111,34,166,59,190,-25,-24,0,0,-42,133,-42,133,-1,2,160,160,160,9.043610907,10.35112092,-1.307510011,0,7.245784642,7.245784642
50,2,4,20,89,Kansas,Jewell County,2932,2926,2937,-6,11,4,20,7,36,-3,-16,0,0,-3,28,-3,28,0,-1,25,25,25,6.822445847,12.28040252,-5.457956677,0,9.551424186,9.551424186
50,2,4,20,91,Kansas,Johnson County,609863,610536,613219,673,2683,1687,6675,1324,5164,363,1511,19,259,288,772,307,1031,3,141,4817,4817,4817,10.90904634,8.439597795,2.469448542,0.423287341,1.261690453,1.684977794
50,2,4,20,93,Kansas,Kearny County,3983,3971,3891,-12,-80,22,51,10,38,12,13,0,1,-25,-92,-25,-91,1,-2,78,78,78,12.97379802,9.666751463,3.307046553,0.254388196,-23.40371407,-23.14932587
50,2,4,20,95,Kansas,Kingman County,7470,7446,7392,-24,-54,22,67,31,156,-9,-89,0,0,-14,36,-14,36,-1,-1,186,186,186,9.030866694,21.0270926,-11.99622591,0,4.852405985,4.852405985
50,2,4,20,97,Kansas,Kiowa County,2460,2452,2392,-8,-60,4,12,5,33,-1,-21,0,0,-7,-38,-7,-38,0,-1,148,148,148,4.954582989,13.62510322,-8.670520231,0,-15.6895128,-15.6895128
50,2,4,20,99,Kansas,Labette County,20184,20119,19912,-65,-207,54,255,84,278,-30,-23,0,1,-34,-185,-34,-184,-1,0,455,455,455,12.7401264,13.88923584,-1.14910944,0.04996128,-9.242836801,-9.192875521
50,2,4,20,101,Kansas,Lane County,1574,1568,1565,-6,-3,3,6,6,27,-3,-21,0,0,-3,17,-3,17,0,1,3,3,3,3.830194702,17.23587616,-13.40568146,0,10.85221832,10.85221832
50,2,4,20,103,Kansas,Leavenworth County,81881,81870,82184,-11,314,209,835,217,771,-8,64,-9,5,6,231,-3,236,0,14,6363,6363,6363,10.17957502,9.399344118,0.7802309,0.060955539,2.816145903,2.877101442
50,2,4,20,105,Kansas,Lincoln County,2939,2947,2903,8,-44,4,19,5,41,-1,-22,0,0,9,-22,9,-22,0,0,36,36,36,6.495726496,14.01709402,-7.521367521,0,-7.521367521,-7.521367521
50,2,4,20,107,Kansas,Linn County,9591,9582,9747,-9,165,28,98,30,123,-2,-25,0,0,-7,193,-7,193,0,-3,42,42,42,10.14020384,12.72699053,-2.586786694,0,19.96999327,19.96999327
50,2,4,20,109,Kansas,Logan County,2762,2743,2722,-19,-21,9,27,10,21,-1,6,0,0,-19,-26,-19,-26,1,-1,37,37,37,9.881061299,7.685269899,2.1957914,0,-9.515096066,-9.515096066
50,2,4,20,111,Kansas,Lyon County,32179,32100,31998,-79,-102,84,353,89,333,-5,20,0,44,-75,-169,-75,-125,1,3,1270,1270,1270,11.01438422,10.39033979,0.624044432,1.37289775,-5.27317545,-3.9002777
50,2,4,20,113,Kansas,McPherson County,30223,30160,30146,-63,-14,63,289,105,402,-42,-113,1,2,-21,93,-20,95,-1,4,927,927,927,9.584452625,13.33200677,-3.747554141,0.066328392,3.084270222,3.150598614
50,2,4,20,115,Kansas,Marion County,11823,11754,11712,-69,-42,21,113,53,168,-32,-55,0,2,-36,9,-36,11,-1,2,687,687,687,9.630955425,14.3185886,-4.687633171,0.170459388,0.767067246,0.937526634
50,2,4,20,117,Kansas,Marshall County,10038,10014,9979,-24,-35,20,112,31,160,-11,-48,0,1,-12,11,-12,12,-1,1,154,154,154,11.20392137,16.00560196,-4.801680588,0.100035012,1.100385135,1.200420147
50,2,4,20,119,Kansas,Meade County,4055,4045,4022,-10,-23,11,63,19,31,-8,32,0,2,-3,-57,-3,-55,1,0,105,105,105,15.61918929,7.685632825,7.933556465,0.495847279,-14.13164745,-13.63580017
50,2,4,20,121,Kansas,Miami County,34191,34183,34593,-8,410,75,305,90,338,-15,-33,0,6,8,438,8,444,-1,-1,554,554,554,8.869373037,9.82901012,-0.959637083,0.17447947,12.73700128,12.91148075
50,2,4,20,123,Kansas,Mitchell County,5796,5764,5748,-32,-16,13,81,30,108,-17,-27,0,0,-14,10,-14,10,-1,1,197,197,197,14.07227241,18.76302988,-4.69075747,0,1.737317582,1.737317582
50,2,4,20,125,Kansas,Montgomery County,31486,31360,31156,-126,-204,73,313,120,457,-47,-144,0,11,-77,-76,-77,-65,-2,5,1022,1022,1022,10.01343656,14.62025721,-4.606820654,0.351909911,-2.431377567,-2.079467656
50,2,4,20,127,Kansas,Morris County,5386,5360,5356,-26,-4,8,31,19,80,-11,-49,0,2,-15,44,-15,46,0,-1,38,38,38,5.785740948,14.93094438,-9.145203434,0.37327361,8.21201941,8.58529302
50,2,4,20,129,Kansas,Morton County,2701,2695,2692,-6,-3,16,51,23,38,-7,13,0,2,2,-18,2,-16,-1,0,80,80,80,18.93447188,14.10803787,4.826434008,0.742528309,-6.68275478,-5.940226471
50,2,4,20,131,Kansas,Nemaha County,10273,10218,10216,-55,-2,23,121,51,112,-28,9,0,0,-27,-13,-27,-13,0,2,228,228,228,11.84300675,10.96212195,0.8808848,0,-1.272389155,-1.272389155
50,2,4,20,133,Kansas,Neosho County,15904,15909,15784,5,-125,49,176,48,230,1,-54,0,14,5,-87,5,-73,-1,2,399,399,399,11.1065535,14.51424605,-3.40769255,0.883475846,-5.490171331,-4.606695485
50,2,4,20,135,Kansas,Ness County,2687,2678,2672,-9,-6,4,23,7,43,-3,-20,0,3,-6,10,-6,13,0,1,50,50,50,8.598130841,16.07476636,-7.476635514,1.121495327,3.738317757,4.859813084
50,2,4,20,137,Kansas,Norton County,5459,5435,5342,-24,-93,15,46,28,77,-13,-31,0,0,-10,-62,-10,-62,-1,0,810,810,810,8.536698525,14.28969101,-5.752992484,0,-11.50598497,-11.50598497
50,2,4,20,139,Kansas,Osage County,15766,15724,15768,-42,44,35,157,58,221,-23,-64,0,0,-18,108,-18,108,-1,0,151,151,151,9.970786231,14.03531056,-4.064524324,0,6.858884796,6.858884796
50,2,4,20,141,Kansas,Osborne County,3500,3494,3498,-6,4,7,40,12,42,-5,-2,0,0,0,6,0,6,-1,0,91,91,91,11.4416476,12.01372998,-0.57208238,0,1.71624714,1.71624714
50,2,4,20,143,Kansas,Ottawa County,5735,5733,5838,-2,105,15,61,19,87,-4,-26,0,1,2,132,2,133,0,-2,79,79,79,10.54360038,15.03759399,-4.493993605,0.172845908,22.81565984,22.98850575
50,2,4,20,145,Kansas,Pawnee County,6253,6244,6225,-9,-19,18,62,29,94,-11,-32,0,0,3,13,3,13,-1,0,957,957,957,9.944662764,15.07739193,-5.132729168,0,2.085171225,2.085171225
50,2,4,20,147,Kansas,Phillips County,4981,4953,4815,-28,-138,11,48,24,81,-13,-33,0,1,-15,-104,-15,-103,0,-2,41,41,41,9.828009828,16.58476659,-6.756756757,0.204750205,-21.29402129,-21.08927109
50,2,4,20,149,Kansas,Pottawatomie County,25348,25392,25790,44,398,79,321,58,212,21,109,0,-1,24,289,24,288,-1,1,270,270,270,12.54347231,8.284162401,4.259309914,-0.039076238,11.29303271,11.25395647
50,2,4,20,151,Kansas,Pratt County,9157,9151,9181,-6,30,21,93,24,135,-3,-42,0,0,-2,72,-2,72,-1,0,350,350,350,10.14619245,14.72834388,-4.582151429,0,7.855116736,7.855116736
50,2,4,20,153,Kansas,Rawlins County,2561,2555,2549,-6,-6,6,22,12,30,-6,-8,0,0,0,2,0,2,0,0,37,37,37,8.620689655,11.75548589,-3.134796238,0,0.78369906,0.78369906
50,2,4,20,155,Kansas,Reno County,61898,61808,61414,-90,-394,158,601,229,840,-71,-239,-2,6,-14,-169,-16,-163,-3,8,2989,2989,2989,9.754751587,13.63392901,-3.87917742,0.097385207,-2.743016669,-2.645631462
50,2,4,20,157,Kansas,Republic County,4674,4680,4662,6,-18,16,42,9,100,7,-58,1,0,-2,41,-1,41,0,-1,93,93,93,8.99165061,21.40869193,-12.41704132,0,8.777563691,8.777563691
50,2,4,20,159,Kansas,Rice County,9427,9374,9390,-53,16,25,87,37,111,-12,-24,0,2,-41,37,-41,39,0,1,616,616,616,9.273076103,11.83116606,-2.558089959,0.213174163,3.943722021,4.156896184
50,2,4,20,161,Kansas,Riley County,71959,71996,72208,37,212,203,742,110,446,93,296,-1,72,-60,-167,-61,-95,5,11,8932,8932,8932,10.29097667,6.185681396,4.105295276,0.998585337,-2.316163213,-1.317577876
50,2,4,20,163,Kansas,Rooks County,4919,4894,4831,-25,-63,12,39,14,94,-2,-55,0,0,-23,-7,-23,-7,0,-1,61,61,61,8.020565553,19.33161954,-11.31105398,0,-1.439588689,-1.439588689
50,2,4,20,165,Kansas,Rush County,2956,2944,2953,-12,9,10,27,12,47,-2,-20,0,0,-10,29,-10,29,0,0,51,51,51,9.157198576,15.94030863,-6.783110056,0,9.835509581,9.835509581
50,2,4,20,167,Kansas,Russell County,6691,6672,6703,-19,31,19,59,27,115,-8,-56,0,-1,-10,90,-10,89,-1,-2,57,57,57,8.822429907,17.19626168,-8.373831776,-0.14953271,13.45794393,13.30841122
50,2,4,20,169,Kansas,Saline County,54303,54232,53888,-71,-344,179,664,168,663,11,1,0,14,-81,-361,-81,-347,-1,2,1395,1395,1395,12.28264891,12.26415094,0.018497965,0.258971513,-6.677765446,-6.418793933
50,2,4,20,171,Kansas,Scott County,5151,5137,5131,-14,-6,18,72,16,59,2,13,0,0,-17,-20,-17,-20,1,1,102,102,102,14.02415271,11.49201402,2.532138683,0,-3.895597974,-3.895597974
50,2,4,20,173,Kansas,Sedgwick County,523824,524246,523828,422,-418,1523,6527,1393,5570,130,957,20,276,266,-1736,286,-1460,6,85,6952,6952,6952,12.4552274,10.62902047,1.826206928,0.526680368,-3.312743184,-2.786062816
50,2,4,20,175,Kansas,Seward County,21964,21832,21747,-132,-85,86,360,44,138,42,222,-1,21,-177,-326,-178,-305,4,-2,474,474,474,16.52171918,6.333325684,10.18839349,0.963766952,-14.96133459,-13.99756764
50,2,4,20,177,Kansas,Shawnee County,178909,178608,178264,-301,-344,514,1992,565,2255,-51,-263,0,36,-244,-153,-244,-117,-6,36,4274,4274,4274,11.16366653,12.63758434,-1.473917819,0.20175301,-0.85745029,-0.655697281
50,2,4,20,179,Kansas,Sheridan County,2447,2442,2478,-5,36,7,37,11,29,-4,8,0,0,0,28,0,28,-1,0,24,24,24,15.04065041,11.78861789,3.25203252,0,11.38211382,11.38211382
50,2,4,20,181,Kansas,Sherman County,5927,5882,5895,-45,13,17,77,25,85,-8,-8,-1,0,-35,20,-36,20,-1,1,95,95,95,13.07633523,14.43491551,-1.358580284,0,3.396450709,3.396450709
50,2,4,20,183,Kansas,Smith County,3570,3559,3576,-11,17,11,29,19,46,-8,-17,0,0,-3,35,-3,35,0,-1,48,48,48,8.128941836,12.8941836,-4.765241766,0,9.810791871,9.810791871
50,2,4,20,185,Kansas,Stafford County,4072,4064,4034,-8,-30,15,50,20,48,-5,2,0,-1,-4,-30,-4,-31,1,-1,58,58,58,12.34872808,11.85477896,0.493949123,-0.246974562,-7.409236849,-7.65621141
50,2,4,20,187,Kansas,Stanton County,2084,2072,2044,-12,-28,2,23,9,15,-7,8,0,1,-5,-37,-5,-36,0,0,45,45,45,11.17589893,7.288629738,3.887269193,0.485908649,-17.97862002,-17.49271137
50,2,4,20,189,Kansas,Stevens County,5250,5236,5293,-14,57,13,55,10,43,3,12,-1,7,-15,38,-16,45,-1,0,47,47,47,10.44733593,8.167917181,2.279418748,1.329660937,7.218159369,8.547820306
50,2,4,20,191,Kansas,Sumner County,22382,22332,22385,-50,53,70,253,69,305,1,-52,0,0,-51,103,-51,103,0,2,325,325,325,11.31560704,13.64134446,-2.325737415,0,4.606749111,4.606749111
50,2,4,20,193,Kansas,Thomas County,7930,7916,7877,-14,-39,19,92,21,92,-2,0,0,-1,-12,-39,-12,-40,0,1,348,348,348,11.65073134,11.65073134,0,-0.126638384,-4.93889698,-5.065535364
50,2,4,20,195,Kansas,Trego County,2808,2808,2793,0,-15,9,27,7,43,2,-16,0,1,-1,0,-1,1,-1,0,60,60,60,9.641135512,15.354401,-5.713265488,0.357079093,0,0.357079093
50,2,4,20,197,Kansas,Wabaunsee County,6877,6885,6966,8,81,23,75,15,73,8,2,0,1,1,78,1,79,-1,0,75,75,75,10.82954299,10.54075518,0.288787813,0.144393907,11.26272471,11.40711862
50,2,4,20,199,Kansas,Wallace County,1512,1514,1508,2,-6,5,14,2,13,3,1,0,0,-1,-6,-1,-6,0,-1,14,14,14,9.265387161,8.603573792,0.661813369,0,-3.970880212,-3.970880212
50,2,4,20,201,Kansas,Washington County,5530,5526,5511,-4,-15,15,70,17,80,-2,-10,0,0,-3,-5,-3,-5,1,0,100,100,100,12.68460632,14.49669294,-1.812086618,0,-0.906043309,-0.906043309
50,2,4,20,203,Kansas,Wichita County,2152,2144,2082,-8,-62,7,22,4,16,3,6,0,2,-12,-68,-12,-66,1,-2,24,24,24,10.41173687,7.572172267,2.8395646,0.946521533,-32.18173213,-31.2352106
50,2,4,20,205,Kansas,Wilson County,8624,8577,8526,-47,-51,28,90,30,125,-2,-35,0,0,-44,-13,-44,-13,-1,-3,112,112,112,10.52446939,14.6173186,-4.092849208,0,-1.520201134,-1.520201134
50,2,4,20,207,Kansas,Woodson County,3115,3103,3102,-12,-1,11,28,8,47,3,-19,0,0,-14,18,-14,18,-1,0,37,37,37,9.024979855,15.14907333,-6.124093473,0,5.801772764,5.801772764
50,2,4,20,209,Kansas,Wyandotte County,169245,168873,167046,-372,-1827,616,2452,445,1725,171,727,4,250,-555,-2788,-551,-2538,8,-16,1245,1245,1245,14.59875744,10.27033303,4.328424412,1.488454062,-16.5992397,-15.11078564
40,3,6,21,0,Kentucky,Kentucky,4505836,4503958,4509394,-1878,5436,12456,50725,14557,56853,-2101,-6128,34,1182,258,10022,292,11204,-69,360,125165,125165,125165,11.25552403,12.61528453,-1.359760498,0.262277563,2.223811963,2.486089526
50,3,6,21,1,Kentucky,Adair County,18903,18870,18932,-33,62,46,193,95,282,-49,-89,0,4,17,146,17,150,-1,1,1357,1357,1357,10.21109994,14.91984551,-4.708745569,0.211629014,7.724459023,7.936088038
50,3,6,21,3,Kentucky,Allen County,20588,20595,20797,7,202,65,237,57,302,8,-65,0,1,0,266,0,267,-1,0,112,112,112,11.45148821,14.59219173,-3.140703518,0.048318516,12.85272516,12.90104368
50,3,6,21,5,Kentucky,Anderson County,23852,23869,24035,17,166,67,240,76,277,-9,-37,0,0,25,204,25,204,1,-1,97,97,97,10.02004008,11.56479626,-1.544756179,0,8.517034068,8.517034068
50,3,6,21,7,Kentucky,Ballard County,7728,7724,7695,-4,-29,17,70,17,115,0,-45,0,0,-3,14,-3,14,-1,2,87,87,87,9.079706855,14.91666126,-5.836954407,0,1.815941371,1.815941371
50,3,6,21,9,Kentucky,Barren County,44485,44445,44544,-40,99,104,512,171,628,-67,-116,0,0,28,208,28,208,-1,7,623,623,623,11.5070402,14.11410399,-2.607063794,0,4.67473508,4.67473508
50,3,6,21,11,Kentucky,Bath County,12750,12708,12778,-42,70,33,165,57,183,-24,-18,0,2,-19,85,-19,87,1,1,89,89,89,12.94828533,14.36082555,-1.412540218,0.156948913,6.670328808,6.827277721
50,3,6,21,13,Kentucky,Bell County,24097,23942,23858,-155,-84,64,273,118,449,-54,-176,0,0,-101,90,-101,90,0,2,759,759,759,11.42259414,18.78661088,-7.364016736,0,3.765690377,3.765690377
50,3,6,21,15,Kentucky,Boone County,135968,136403,137412,435,1009,407,1624,242,1264,165,360,0,87,267,538,267,625,3,24,752,752,752,11.86202363,9.232511002,2.629512627,0.635465552,3.929660537,4.565126089
50,3,6,21,17,Kentucky,Bourbon County,20252,20285,20229,33,-56,44,188,56,264,-12,-76,0,-2,47,18,47,16,-2,4,208,208,208,9.280742459,13.03253196,-3.751789505,-0.098731303,0.888581725,0.789850422
50,3,6,21,19,Kentucky,Boyd County,48261,48175,47899,-86,-276,123,501,208,719,-85,-218,0,-1,2,-67,2,-68,-3,10,1898,1898,1898,10.42946062,14.96762912,-4.538168495,-0.020817287,-1.394758207,-1.415575494
50,3,6,21,21,Kentucky,Boyle County,30614,30701,30747,87,46,78,283,118,408,-40,-125,0,8,129,159,129,167,-2,4,3148,3148,3148,9.211040229,13.2795209,-4.068480667,0.260382763,5.175107408,5.435490171
50,3,6,21,23,Kentucky,Bracken County,8400,8390,8439,-10,49,32,92,30,105,2,-13,0,0,-11,61,-11,61,-1,1,26,26,26,10.93350764,12.4784598,-1.544952166,0,7.249390932,7.249390932
50,3,6,21,25,Kentucky,Breathitt County,13718,13679,13553,-39,-126,35,164,67,212,-32,-48,0,0,-7,-79,-7,-79,0,1,327,327,327,12.04465335,15.56991774,-3.525264395,0,-5.80199765,-5.80199765
50,3,6,21,27,Kentucky,Breckinridge County,20432,20432,20651,0,219,70,234,81,274,-11,-40,0,0,13,259,13,259,-2,0,245,245,245,11.39157316,13.33885062,-1.947277463,0,12.60862157,12.60862157
50,3,6,21,29,Kentucky,Bullitt County,82217,82293,82918,76,625,212,784,218,861,-6,-77,0,6,83,691,83,697,-1,5,281,281,281,9.490893464,10.42303479,-0.932141322,0.072634389,8.365060438,8.437694827
50,3,6,21,31,Kentucky,Butler County,12371,12318,12294,-53,-24,37,133,52,181,-15,-48,0,2,-38,21,-38,23,0,1,138,138,138,10.80773606,14.70827239,-3.900536324,0.162522347,1.706484642,1.869006989
50,3,6,21,33,Kentucky,Caldwell County,12649,12632,12624,-17,-8,36,124,52,186,-16,-62,0,-2,0,54,0,52,-1,2,109,109,109,9.819448844,14.72917327,-4.909724422,-0.158378207,4.276211593,4.117833386
50,3,6,21,35,Kentucky,Calloway County,37103,37147,37560,44,413,89,306,112,502,-23,-196,1,11,66,603,67,614,0,-5,2920,2920,2920,8.192003427,13.43916902,-5.247165594,0.294483783,16.14306558,16.43754936
50,3,6,21,37,Kentucky,Campbell County,93076,93086,93050,10,-36,253,998,246,1048,7,-50,0,20,4,-18,4,2,-1,12,3023,3023,3023,10.72334207,11.26058366,-0.537241587,0.214896635,-0.193406971,0.021489664
50,3,6,21,39,Kentucky,Carlisle County,4826,4811,4791,-15,-20,15,50,26,60,-11,-10,0,0,-4,-10,-4,-10,0,0,53,53,53,10.41449698,12.49739638,-2.082899396,0,-2.082899396,-2.082899396
50,3,6,21,41,Kentucky,Carroll County,10810,10833,10863,23,30,35,155,29,156,6,-1,0,0,17,29,17,29,0,2,292,292,292,14.28834808,14.38053097,-0.092182891,0,2.673303835,2.673303835
50,3,6,21,43,Kentucky,Carter County,26627,26575,26412,-52,-163,72,277,92,411,-20,-134,0,0,-30,-34,-30,-34,-2,5,535,535,535,10.45539472,15.5132391,-5.057844377,0,-1.283333648,-1.283333648
50,3,6,21,45,Kentucky,Casey County,15941,15886,15866,-55,-20,42,162,69,275,-27,-113,0,0,-27,92,-27,92,-1,1,402,402,402,10.20408163,17.32174351,-7.11766188,0,5.794910557,5.794910557
50,3,6,21,47,Kentucky,Christian County,72748,72696,72357,-52,-339,378,1484,178,811,200,673,-5,-24,-250,-981,-255,-1005,3,-7,6159,6159,6159,20.46148649,11.18211964,9.279366852,-0.330913528,-13.52609046,-13.85700399
50,3,6,21,49,Kentucky,Clark County,36972,36999,36871,27,-128,92,403,111,462,-19,-59,1,8,46,-84,47,-76,-1,7,413,413,413,10.91105997,12.50846081,-1.597400839,0.216596724,-2.274265602,-2.057668878
50,3,6,21,51,Kentucky,Clay County,20345,20294,20206,-51,-88,48,221,71,285,-23,-64,0,0,-28,-27,-28,-27,0,3,1625,1625,1625,10.91358025,14.07407407,-3.160493827,0,-1.333333333,-1.333333333
50,3,6,21,53,Kentucky,Clinton County,9253,9216,9265,-37,49,22,102,42,160,-20,-58,0,0,-16,107,-16,107,-1,0,80,80,80,11.03836373,17.31508035,-6.276716628,0,11.57945999,11.57945999
50,3,6,21,55,Kentucky,Crittenden County,8990,8985,8947,-5,-38,21,98,41,119,-20,-21,0,0,16,-17,16,-17,-1,0,187,187,187,10.93018068,13.27236226,-2.342181575,0,-1.896051751,-1.896051751
50,3,6,21,57,Kentucky,Cumberland County,5888,5856,5879,-32,23,13,73,30,125,-17,-52,0,1,-14,74,-14,75,-1,0,42,42,42,12.44141457,21.30379208,-8.862377503,0.170430337,12.61184491,12.78227525
50,3,6,21,59,Kentucky,Daviess County,103312,103291,103063,-21,-228,273,1206,336,1209,-63,-3,0,33,46,-277,46,-244,-4,19,2656,2656,2656,11.68865154,11.71772779,-0.029076248,0.319838724,-2.684706863,-2.364868139
50,3,6,21,61,Kentucky,Edmonson County,12126,12132,12291,6,159,17,112,44,167,-27,-55,-1,1,35,215,34,216,-1,-2,312,312,312,9.171682431,13.67563362,-4.503951194,0.081890022,17.60635467,17.68824469
50,3,6,21,63,Kentucky,Elliott County,7354,7334,7381,-20,47,15,43,22,76,-7,-33,0,0,-12,80,-12,80,-1,0,986,986,986,5.844376487,10.32959565,-4.485219164,0,10.87325858,10.87325858
50,3,6,21,65,Kentucky,Estill County,14163,14134,14092,-29,-42,30,139,62,206,-32,-67,0,0,4,22,4,22,-1,3,103,103,103,9.849075321,14.59647134,-4.747396018,0,1.558846454,1.558846454
50,3,6,21,67,Kentucky,Fayette County,322570,322403,321793,-167,-610,927,3631,844,2945,83,686,11,226,-269,-1564,-258,-1338,8,42,12705,12705,12705,11.27296661,9.143180026,2.129786587,0.701649808,-4.855665046,-4.154015238
50,3,6,21,69,Kentucky,Fleming County,15082,15091,15224,9,133,50,179,44,221,6,-42,0,0,3,177,3,177,0,-2,19,19,19,11.80933531,14.58024081,-2.770905492,0,11.67738743,11.67738743
50,3,6,21,71,Kentucky,Floyd County,35942,35756,35274,-186,-482,85,405,175,671,-90,-266,0,1,-96,-219,-96,-218,0,2,638,638,638,11.40363227,18.89342531,-7.489793045,0.028157117,-6.16640856,-6.138251443
50,3,6,21,73,Kentucky,Franklin County,51541,51569,51682,28,113,131,499,161,658,-30,-159,2,32,57,231,59,263,-1,9,1821,1821,1821,9.665765949,12.74563927,-3.079873318,0.619848718,4.474532934,5.094381653
50,3,6,21,75,Kentucky,Fulton County,6515,6501,6512,-14,11,11,70,25,109,-14,-39,0,0,2,50,2,50,-2,0,446,446,446,10.7584723,16.75247829,-5.994005994,0,7.684623069,7.684623069
50,3,6,21,77,Kentucky,Gallatin County,8690,8667,8775,-23,108,27,95,30,93,-3,2,0,1,-20,108,-20,109,0,-3,57,57,57,10.89324619,10.66391469,0.229331499,0.114665749,12.38390093,12.49856668
50,3,6,21,79,Kentucky,Garrard County,16953,16935,17362,-18,427,47,169,76,219,-29,-50,0,-1,11,485,11,484,0,-7,55,55,55,9.855089366,12.77079628,-2.915706913,-0.058314138,28.28235706,28.22404292
50,3,6,21,81,Kentucky,Grant County,24941,25008,25244,67,236,88,327,63,309,25,18,0,-1,41,218,41,217,1,1,368,368,368,13.01440739,12.29801799,0.716389397,-0.039799411,8.676271591,8.63647218
50,3,6,21,83,Kentucky,Graves County,36649,36512,36615,-137,103,104,410,147,531,-43,-121,1,3,-94,218,-93,221,-1,3,377,377,377,11.21336852,14.52267972,-3.309311198,0.082049038,5.962230093,6.044279131
50,3,6,21,85,Kentucky,Grayson County,26420,26410,26524,-10,114,77,308,99,380,-22,-72,0,-1,14,185,14,184,-2,2,694,694,694,11.63713303,14.3575018,-2.720368761,-0.037782899,6.9898364,6.952053501
50,3,6,21,87,Kentucky,Green County,11107,11112,11291,5,179,28,108,46,160,-18,-52,0,-1,24,236,24,235,-1,-4,89,89,89,9.641565862,14.28380128,-4.642235415,-0.089273758,21.06860688,20.97933313
50,3,6,21,89,Kentucky,Greenup County,35962,35852,35649,-110,-203,60,328,132,560,-72,-232,0,1,-35,22,-35,23,-3,6,425,425,425,9.174696857,15.66411659,-6.489419728,0.027971637,0.615376009,0.643347646
50,3,6,21,91,Kentucky,Hancock County,9095,9092,9064,-3,-28,19,88,28,123,-9,-35,0,0,6,5,6,5,0,2,86,86,86,9.693765147,13.54923992,-3.855474774,0,0.550782111,0.550782111
50,3,6,21,93,Kentucky,Hardin County,110702,110719,111607,17,888,366,1334,343,1213,23,121,0,9,-8,749,-8,758,2,9,2995,2995,2995,12.00039582,10.91190414,1.088491674,0.080962191,6.737853423,6.818815613
50,3,6,21,95,Kentucky,Harlan County,26831,26689,26164,-142,-525,79,302,154,525,-75,-223,0,1,-66,-303,-66,-302,-1,0,616,616,616,11.42792273,19.86642196,-8.438499234,0.037840804,-11.46576353,-11.42792273
50,3,6,21,97,Kentucky,Harrison County,18692,18705,18950,13,245,50,211,59,259,-9,-48,0,0,23,293,23,293,-1,0,214,214,214,11.20701102,13.75647324,-2.549462223,0,15.56234232,15.56234232
50,3,6,21,99,Kentucky,Hart County,19288,19271,19460,-17,189,67,231,72,254,-5,-23,0,2,-11,209,-11,211,-1,1,199,199,199,11.92842942,13.11610854,-1.18767912,0.103276445,10.79238853,10.89566497
50,3,6,21,101,Kentucky,Henderson County,44793,44645,44329,-148,-316,125,478,155,654,-30,-176,0,2,-117,-148,-117,-146,-1,6,1054,1054,1054,10.74471194,14.70092387,-3.956211927,0.044956954,-3.326814575,-3.281857621
50,3,6,21,103,Kentucky,Henry County,15678,15666,15657,-12,-9,41,167,60,189,-19,-22,0,1,8,10,8,11,-1,2,47,47,47,10.66309102,12.0678096,-1.404718577,0.063850844,0.638508444,0.702359289
50,3,6,21,105,Kentucky,Hickman County,4521,4521,4424,0,-97,6,28,15,77,-9,-49,0,0,10,-48,10,-48,-1,0,207,207,207,6.260480716,17.21632197,-10.95584125,0,-10.73225266,-10.73225266
50,3,6,21,107,Kentucky,Hopkins County,45423,45367,45138,-56,-229,118,512,188,690,-70,-178,0,3,16,-60,16,-57,-2,6,1029,1029,1029,11.31429203,15.24777637,-3.933484338,0.06629468,-1.325893597,-1.259598917
50,3,6,21,109,Kentucky,Jackson County,12955,12951,12984,-4,33,35,161,49,211,-14,-50,0,0,10,83,10,83,0,0,62,62,62,12.41565452,16.27144785,-3.855793329,0,6.400616927,6.400616927
50,3,6,21,111,Kentucky,Jefferson County,782969,782123,777874,-846,-4249,2208,9278,2498,9686,-290,-408,27,527,-572,-4458,-545,-3931,-11,90,16932,16932,16932,11.89489467,12.4179726,-0.523077929,0.675642325,-5.715395607,-5.039753282
50,3,6,21,113,Kentucky,Jessamine County,52991,52972,53626,-19,654,143,591,146,551,-3,40,0,14,-16,598,-16,612,0,2,1464,1464,1464,11.08838815,10.33790503,0.750483124,0.262669093,11.2197227,11.48239179
50,3,6,21,115,Kentucky,Johnson County,22680,22634,22556,-46,-78,48,220,71,349,-23,-129,0,-1,-22,48,-22,47,-1,4,505,505,505,9.736667404,15.44589511,-5.709227705,-0.044257579,2.124363797,2.080106218
50,3,6,21,117,Kentucky,Kenton County,169064,169183,169495,119,312,544,2188,424,1757,120,431,0,42,-3,-191,-3,-149,2,30,2545,2545,2545,12.92082745,10.37563704,2.545190417,0.248023196,-1.127915011,-0.879891815
50,3,6,21,119,Kentucky,Knott County,14251,14160,14053,-91,-107,25,129,61,213,-36,-84,0,0,-55,-24,-55,-24,0,1,667,667,667,9.144720519,15.09942225,-5.954701733,0,-1.701343352,-1.701343352
50,3,6,21,121,Kentucky,Knox County,30193,30135,29909,-58,-226,78,391,125,522,-47,-131,-1,1,-9,-100,-10,-99,-1,4,542,542,542,13.02378256,17.38724935,-4.363466791,0.033308907,-3.33089068,-3.297581773
50,3,6,21,123,Kentucky,Larue County,14867,14870,15028,3,158,39,158,49,179,-10,-21,0,-1,14,182,14,181,-1,-2,299,299,299,10.56926885,11.97404509,-1.404776239,-0.066894107,12.17472741,12.1078333
50,3,6,21,125,Kentucky,Laurel County,62613,62662,62561,49,-101,160,709,217,858,-57,-149,-1,1,108,33,107,34,-1,14,659,659,659,11.32379834,13.70355286,-2.379754518,0.015971507,0.527059725,0.543031232
50,3,6,21,127,Kentucky,Lawrence County,16293,16288,16290,-5,2,43,188,60,228,-17,-40,1,0,11,39,12,39,0,3,105,105,105,11.5415311,13.99717601,-2.455644914,0,2.394253791,2.394253791
50,3,6,21,129,Kentucky,Lee County,7395,7360,7451,-35,91,17,62,36,136,-19,-74,-1,1,-15,166,-16,167,0,-2,986,986,986,8.37215583,18.36472892,-9.992573088,0.135034772,22.41577206,22.55080683
50,3,6,21,131,Kentucky,Leslie County,10513,10455,10278,-58,-177,32,99,45,165,-13,-66,0,1,-44,-112,-44,-111,-1,0,225,225,225,9.549992765,15.91665461,-6.366661843,0.096464573,-10.80403222,-10.70756765
50,3,6,21,133,Kentucky,Letcher County,21548,21428,21253,-120,-175,45,212,104,352,-59,-140,0,1,-59,-40,-59,-39,-2,4,206,206,206,9.934162742,16.49445889,-6.560296151,0.046859258,-1.874370329,-1.82751107
50,3,6,21,135,Kentucky,Lewis County,13080,13061,12987,-19,-74,38,153,45,192,-7,-39,0,0,-11,-36,-11,-36,-1,1,88,88,88,11.747543,14.74201474,-2.994471744,0,-2.764127764,-2.764127764
50,3,6,21,137,Kentucky,Lincoln County,24275,24238,24243,-37,5,69,296,92,370,-23,-74,0,-1,-14,79,-14,78,0,1,164,164,164,12.21096925,15.26371156,-3.052742311,-0.041253274,3.259008684,3.217755409
50,3,6,21,139,Kentucky,Livingston County,8888,8845,8959,-43,114,19,80,47,165,-28,-85,0,0,-14,202,-14,202,-1,-3,41,41,41,8.986744552,18.53516064,-9.548416086,0,22.69152999,22.69152999
50,3,6,21,141,Kentucky,Logan County,27432,27497,27771,65,274,105,344,102,358,3,-14,0,4,64,284,64,288,-2,0,230,230,230,12.44843309,12.95505537,-0.506622277,0.144749222,10.27719476,10.42194398
50,3,6,21,143,Kentucky,Lyon County,8680,8664,8803,-16,139,10,49,30,160,-20,-111,0,-1,6,254,6,253,-2,-3,1152,1152,1152,5.610579951,18.32026106,-12.70968111,-0.114501632,29.08341444,28.96891281
50,3,6,21,145,Kentucky,McCracken County,67875,67836,67454,-39,-382,178,679,251,980,-73,-301,0,-2,38,-91,38,-93,-4,12,1157,1157,1157,10.0376968,14.48739744,-4.449700643,-0.029566117,-1.345258334,-1.374824451
50,3,6,21,147,Kentucky,McCreary County,16888,16851,16892,-37,41,41,195,53,228,-12,-33,0,3,-25,69,-25,72,0,2,1807,1807,1807,11.55795276,13.513914,-1.955961236,0.177814658,4.089737131,4.267551789
50,3,6,21,149,Kentucky,McLean County,9152,9114,9100,-38,-14,22,98,42,154,-20,-56,0,0,-18,40,-18,40,0,2,59,59,59,10.76095311,16.91006918,-6.149116065,0,4.39222576,4.39222576
50,3,6,21,151,Kentucky,Madison County,92701,92920,94666,219,1746,234,979,257,1029,-23,-50,0,7,237,1802,237,1809,5,-13,6263,6263,6263,10.43787916,10.97096798,-0.533088823,0.074632435,19.21252119,19.28715363
50,3,6,21,153,Kentucky,Magoffin County,11637,11594,11497,-43,-97,33,142,45,171,-12,-29,0,-1,-30,-69,-30,-70,-1,2,86,86,86,12.29916418,14.81096531,-2.511801135,-0.086613832,-5.976354424,-6.062968256
50,3,6,21,155,Kentucky,Marion County,19581,19580,19725,-1,145,54,211,68,262,-14,-51,0,0,13,196,13,196,0,0,466,466,466,10.73654751,13.3316372,-2.595089683,0,9.973285842,9.973285842
50,3,6,21,157,Kentucky,Marshall County,31659,31665,31748,6,83,84,271,133,499,-49,-228,-1,1,60,310,59,311,-4,0,423,423,423,8.54714333,15.73809787,-7.190954536,0.031539274,9.777175027,9.808714302
50,3,6,21,159,Kentucky,Martin County,11287,11228,11140,-59,-88,28,104,54,145,-26,-41,0,-1,-34,-46,-34,-47,1,0,1360,1360,1360,9.298998569,12.96494993,-3.665951359,-0.089413448,-4.113018598,-4.202432046
50,3,6,21,161,Kentucky,Mason County,17120,17085,16931,-35,-154,43,200,76,227,-33,-27,0,2,-1,-132,-1,-130,-1,3,253,253,253,11.75917215,13.3466604,-1.587488241,0.117591722,-7.761053622,-7.6434619
50,3,6,21,163,Kentucky,Meade County,30003,29981,30131,-22,150,55,268,81,281,-26,-13,0,1,5,160,5,161,-1,2,207,207,207,8.916688848,9.349214799,-0.432525952,0.033271227,5.323396327,5.356667554
50,3,6,21,165,Kentucky,Menifee County,6113,6115,6194,2,79,18,72,27,106,-9,-34,0,0,12,113,12,113,-1,0,216,216,216,11.69875701,17.22317004,-5.524413031,0,18.36054919,18.36054919
50,3,6,21,167,Kentucky,Mercer County,22641,22616,22850,-25,234,54,226,85,308,-31,-82,0,0,6,319,6,319,0,-3,112,112,112,9.941494743,13.54858576,-3.607091013,0,14.03246382,14.03246382
50,3,6,21,169,Kentucky,Metcalfe County,10286,10271,10349,-15,78,26,110,47,169,-21,-59,0,0,7,139,7,139,-1,-2,106,106,106,10.66925315,16.39185257,-5.722599418,0,13.48205626,13.48205626
50,3,6,21,171,Kentucky,Monroe County,11338,11301,11233,-37,-68,24,117,41,171,-17,-54,0,0,-20,-15,-20,-15,0,1,140,140,140,10.38430816,15.17706577,-4.792757611,0,-1.331321559,-1.331321559
50,3,6,21,173,Kentucky,Montgomery County,28114,28091,28219,-23,128,66,321,81,360,-15,-39,0,-2,-7,166,-7,164,-1,3,295,295,295,11.40117208,12.78636122,-1.385189132,-0.07103534,5.895933227,5.824897887
50,3,6,21,175,Kentucky,Morgan County,13726,13719,13820,-7,101,34,119,48,176,-14,-57,0,0,7,159,7,159,0,-1,1848,1848,1848,8.642289117,12.78187298,-4.139583863,0,11.54726025,11.54726025
50,3,6,21,177,Kentucky,Muhlenberg County,30928,30875,30694,-53,-181,80,321,99,479,-19,-158,-1,-2,-32,-27,-33,-29,-1,6,2017,2017,2017,10.42732544,15.55977846,-5.13245302,-0.06496776,-0.877064757,-0.942032516
50,3,6,21,179,Kentucky,Nelson County,46738,46756,47098,18,342,118,519,134,546,-16,-27,0,-2,34,367,34,365,0,4,433,433,433,11.05973107,11.6350928,-0.575361732,-0.042619388,7.820657617,7.77803823
50,3,6,21,181,Kentucky,Nicholas County,7537,7536,7712,-1,176,18,79,22,118,-4,-39,0,0,4,218,4,218,-1,-3,91,91,91,10.36201469,15.47743966,-5.115424974,0,28.59391396,28.59391396
50,3,6,21,183,Kentucky,Ohio County,23772,23726,23688,-46,-38,56,263,68,342,-12,-79,0,-4,-32,40,-32,36,-2,5,238,238,238,11.09376977,14.42611887,-3.332349095,-0.168726536,1.687265365,1.518538828
50,3,6,21,185,Kentucky,Oldham County,67607,67642,68685,35,1043,126,539,141,528,-15,11,0,4,48,1036,48,1040,2,-8,4336,4336,4336,7.907457804,7.746081114,0.16137669,0.058682433,15.19875006,15.2574325
50,3,6,21,187,Kentucky,Owen County,11278,11294,11294,16,0,21,87,44,152,-23,-65,0,0,40,65,40,65,-1,0,0,0,0,7.703205242,13.45847353,-5.755268284,0,5.755268284,5.755268284
50,3,6,21,189,Kentucky,Owsley County,4051,4018,3953,-33,-65,6,41,26,91,-20,-50,0,0,-14,-14,-14,-14,1,-1,44,44,44,10.28729143,22.83276879,-12.54547736,0,-3.51273366,-3.51273366
50,3,6,21,191,Kentucky,Pendleton County,14644,14640,14607,-4,-33,36,169,43,197,-7,-28,0,2,5,-10,5,-8,-2,3,183,183,183,11.55674086,13.47146716,-1.914726297,0.136766164,-0.68383082,-0.547064656
50,3,6,21,193,Kentucky,Perry County,28473,28378,27929,-95,-449,89,287,126,505,-37,-218,0,3,-57,-235,-57,-232,-1,1,618,618,618,10.19411441,17.93737901,-7.743264603,0.106558687,-8.347097164,-8.240538477
50,3,6,21,195,Kentucky,Pike County,58669,58408,57391,-261,-1017,138,538,249,998,-111,-460,0,2,-148,-560,-148,-558,-2,1,1419,1419,1419,9.291962798,17.2367637,-7.944800905,0.034542613,-9.671931537,-9.637388924
50,3,6,21,197,Kentucky,Powell County,13129,13085,13133,-44,48,32,159,55,163,-23,-4,0,1,-21,48,-21,49,0,3,186,186,186,12.12907163,12.43420551,-0.305133877,0.076283469,3.66160653,3.737889999
50,3,6,21,199,Kentucky,Pulaski County,65034,65016,65423,-18,407,163,684,270,1003,-107,-319,0,-1,92,728,92,727,-3,-1,853,853,853,10.4876609,15.37883608,-4.891175185,-0.015332838,11.16230575,11.14697292
50,3,6,21,201,Kentucky,Robertson County,2193,2184,2257,-9,73,5,21,11,43,-6,-22,0,0,-2,97,-2,97,-1,-2,55,55,55,9.45732943,19.36500788,-9.907678451,0,43.68385499,43.68385499
50,3,6,21,203,Kentucky,Rockcastle County,16037,16053,16115,16,62,34,150,44,273,-10,-123,0,0,27,185,27,185,-1,0,215,215,215,9.326038299,16.9733897,-7.647351405,0,11.5021139,11.5021139
50,3,6,21,205,Kentucky,Rowan County,24662,24732,24861,70,129,80,232,71,251,9,-19,0,0,61,145,61,145,0,3,2961,2961,2961,9.356159135,10.12239631,-0.766237171,0,5.84759946,5.84759946
50,3,6,21,207,Kentucky,Russell County,17991,17975,18156,-16,181,50,176,90,284,-40,-108,0,-1,24,292,24,291,0,-2,135,135,135,9.742326534,15.72057236,-5.978245828,-0.055354128,16.16340539,16.10805126
50,3,6,21,209,Kentucky,Scott County,57155,57477,58252,322,775,194,673,154,498,40,175,0,6,277,588,277,594,5,6,983,983,983,11.63061981,8.606313024,3.024306786,0.103690518,10.1616708,10.26536132
50,3,6,21,211,Kentucky,Shelby County,48065,48179,48461,114,282,128,560,117,512,11,48,0,16,103,209,103,225,0,9,1565,1565,1565,11.58940397,10.59602649,0.993377483,0.331125828,4.325331126,4.656456954
50,3,6,21,213,Kentucky,Simpson County,19594,19620,19718,26,98,57,232,53,255,4,-23,0,-1,22,120,22,119,0,2,322,322,322,11.79521074,12.96456353,-1.169352789,-0.050841426,6.100971071,6.050129646
50,3,6,21,215,Kentucky,Spencer County,19490,19564,19916,74,352,45,176,41,205,4,-29,0,0,69,386,69,386,1,-5,78,78,78,8.915906788,10.38500507,-1.469098278,0,19.55420466,19.55420466
50,3,6,21,217,Kentucky,Taylor County,26023,26020,26235,-3,215,90,295,92,394,-2,-99,0,9,-1,306,-1,315,0,-1,1305,1305,1305,11.29078557,15.07989666,-3.78911109,0.344464645,11.71179791,12.05626256
50,3,6,21,219,Kentucky,Todd County,12243,12280,12285,37,5,44,157,32,158,12,-1,0,-5,25,9,25,4,0,2,142,142,142,12.782414,12.86383065,-0.08141665,-0.407083249,0.732749847,0.325666599
50,3,6,21,221,Kentucky,Trigg County,14061,14068,14192,7,124,33,167,57,240,-24,-73,0,3,33,195,33,198,-2,-1,38,38,38,11.8188252,16.985138,-5.16631281,0.212314225,13.80042463,14.01273885
50,3,6,21,223,Kentucky,Trimble County,8474,8461,8530,-13,69,19,80,25,126,-6,-46,0,-1,-7,118,-7,117,0,-2,23,23,23,9.416750044,14.83138132,-5.414631275,-0.117709376,13.88970632,13.77199694
50,3,6,21,225,Kentucky,Union County,13668,13646,13544,-22,-102,38,148,52,192,-14,-44,0,0,-7,-57,-7,-57,-1,-1,1496,1496,1496,10.88635528,14.12283928,-3.236484001,0,-4.192717911,-4.192717911
50,3,6,21,227,Kentucky,Warren County,134554,134933,137212,379,2279,385,1712,325,1301,60,411,2,133,311,1733,313,1866,6,2,6392,6392,6392,12.58152823,9.561079572,3.020448658,0.977420125,12.73585772,13.71327785
50,3,6,21,229,Kentucky,Washington County,12027,12024,12072,-3,48,34,124,45,168,-11,-44,0,-2,9,92,9,90,-1,2,163,163,163,10.29216468,13.94422311,-3.652058433,-0.166002656,7.636122178,7.470119522
50,3,6,21,231,Kentucky,Wayne County,19555,19528,19540,-27,12,53,209,71,300,-18,-91,0,-2,-7,102,-7,100,-2,3,242,242,242,10.69929354,15.35783762,-4.658544077,-0.102385584,5.22166479,5.119279206
50,3,6,21,233,Kentucky,Webster County,13017,12989,12813,-28,-176,41,146,55,210,-14,-64,-1,0,-13,-112,-14,-112,0,0,362,362,362,11.31695217,16.27780792,-4.960855748,0,-8.681497558,-8.681497558
50,3,6,21,235,Kentucky,Whitley County,36712,36687,36939,-25,252,121,516,122,570,-1,-54,0,3,-23,299,-23,302,-1,4,1844,1844,1844,14.01678755,15.48366066,-1.466873115,0.081492951,8.122130769,8.20362372
50,3,6,21,237,Kentucky,Wolfe County,6562,6552,6507,-10,-45,17,84,27,123,-10,-39,0,0,1,-7,1,-7,-1,1,80,80,80,12.86469102,18.83758328,-5.972892258,0,-1.072057585,-1.072057585
50,3,6,21,239,Kentucky,Woodford County,26871,26892,27075,21,183,62,235,64,288,-2,-53,0,-8,24,243,24,235,-1,1,491,491,491,8.709025886,10.67318917,-1.964163285,-0.296477477,9.005503363,8.709025886
40,3,7,22,0,Louisiana,Louisiana,4657757,4651203,4624047,-6554,-27156,13337,55942,13460,55335,-123,607,88,2692,-6542,-30312,-6454,-27620,23,-143,121748,121748,121748,12.06263982,11.93175386,0.13088596,0.580469529,-6.536104148,-5.955634619
50,3,7,22,1,Louisiana,Acadia Parish,57576,57455,57288,-121,-167,169,820,204,833,-35,-13,1,2,-87,-167,-86,-165,0,11,759,759,759,14.29281089,14.51940423,-0.226593343,0.034860514,-2.91085295,-2.875992435
50,3,7,22,3,Louisiana,Allen Parish,22750,22697,22687,-53,-10,67,301,77,291,-10,10,0,11,-44,-35,-44,-24,1,4,3638,3638,3638,13.26458664,12.8239027,0.440683942,0.484752336,-1.542393795,-1.05764146
50,3,7,22,5,Louisiana,Ascension Parish,126500,126984,128369,484,1385,378,1570,187,1039,191,531,8,61,279,773,287,834,6,20,636,636,636,12.296703,8.137754403,4.158948593,0.477769989,6.054363959,6.532133948
50,3,7,22,7,Louisiana,Assumption Parish,21039,20968,20689,-71,-279,63,218,58,282,5,-64,-1,5,-74,-219,-75,-214,-1,-1,116,116,116,10.46642821,13.53914108,-3.072712869,0.240055693,-10.51443935,-10.27438366
50,3,7,22,9,Louisiana,Avoyelles Parish,39693,39616,39236,-77,-380,114,453,141,584,-27,-131,0,10,-49,-263,-49,-253,-1,4,3160,3160,3160,11.48987978,14.81256024,-3.322680465,0.25363973,-6.670724902,-6.417085172
50,3,7,22,11,Louisiana,Beauregard Parish,36549,36573,36584,24,11,86,476,96,464,-10,12,1,10,34,-17,35,-7,-1,6,1115,1115,1115,13.01310879,12.68504723,0.328061566,0.273384639,-0.464753885,-0.191369247
50,3,7,22,13,Louisiana,Bienville Parish,12981,12899,12776,-82,-123,20,141,52,235,-32,-94,0,1,-50,-31,-50,-30,0,1,250,250,250,10.98344693,18.30574489,-7.322297955,0.077896787,-2.414800389,-2.336903603
50,3,7,22,15,Louisiana,Bossier Parish,128746,128615,129144,-131,529,372,1581,340,1400,32,181,-1,76,-165,245,-166,321,3,27,2427,2427,2427,12.26727292,10.86286027,1.404412649,0.589698129,1.901000547,2.490698676
50,3,7,22,17,Louisiana,Caddo Parish,237848,237056,233092,-792,-3964,720,2991,740,3302,-20,-311,-2,42,-766,-3664,-768,-3622,-4,-31,5959,5959,5959,12.72365298,14.04664063,-1.322987655,0.178667143,-15.58658125,-15.4079141
50,3,7,22,19,Louisiana,Calcasieu Parish,216785,216416,205282,-369,-11134,699,2826,624,2468,75,358,2,92,-450,-11380,-448,-11288,4,-204,3883,3883,3883,13.40295662,11.70505907,1.697897548,0.436331213,-53.972274,-53.53594278
50,3,7,22,21,Louisiana,Caldwell Parish,9645,9617,9571,-28,-46,32,91,35,147,-3,-56,0,2,-25,6,-25,8,0,2,515,515,515,9.485094851,15.3220763,-5.836981447,0.208463623,0.625390869,0.833854492
50,3,7,22,23,Louisiana,Cameron Parish,5617,5619,5080,2,-539,14,71,18,67,-4,4,0,-2,6,-534,6,-536,0,-7,9,9,9,13.27226844,12.524535,0.747733433,-0.373866717,-99.82241331,-100.19628
50,3,7,22,25,Louisiana,Catahoula Parish,8906,8859,8805,-47,-54,33,116,30,114,3,2,0,0,-50,-57,-50,-57,0,1,761,761,761,13.13405797,12.9076087,0.226449275,0,-6.453804348,-6.453804348
50,3,7,22,27,Louisiana,Claiborne Parish,14170,14109,14038,-61,-71,35,141,69,213,-34,-72,0,0,-27,-1,-27,-1,0,2,2547,2547,2547,10.01882972,15.13482787,-5.115998153,0,-0.07105553,-0.07105553
50,3,7,22,29,Louisiana,Concordia Parish,18687,18589,18376,-98,-213,60,212,61,292,-1,-80,-1,18,-96,-152,-97,-134,0,1,1348,1348,1348,11.47030975,15.79872853,-4.328418775,0.973894224,-8.223995672,-7.250101447
50,3,7,22,31,Louisiana,De Soto Parish,26812,26854,26919,42,65,74,321,84,380,-10,-59,0,0,51,121,51,121,1,3,126,126,126,11.93907723,14.13348707,-2.194409834,0,4.500399829,4.500399829
50,3,7,22,33,Louisiana,East Baton Rouge Parish,456781,455884,453301,-897,-2583,1340,5476,1209,4757,131,719,21,477,-1058,-3812,-1037,-3335,9,33,11341,11341,11341,12.04595324,10.46431694,1.581636301,1.049291398,-8.385532097,-7.336240699
50,3,7,22,35,Louisiana,East Carroll Parish,7459,7383,7220,-76,-163,12,73,23,88,-11,-15,0,0,-64,-147,-64,-147,-1,-1,1147,1147,1147,9.997945628,12.05231802,-2.054372389,0,-20.13284941,-20.13284941
50,3,7,22,37,Louisiana,East Feliciana Parish,19539,19451,19338,-88,-113,38,172,87,282,-49,-110,0,1,-39,-6,-39,-5,0,2,2445,2445,2445,8.868493645,14.5402047,-5.671711052,0.05156101,-0.309366057,-0.257805048
50,3,7,22,39,Louisiana,Evangeline Parish,32350,32307,32215,-43,-92,113,436,97,471,16,-35,0,41,-59,-104,-59,-63,0,6,1190,1190,1190,13.51477016,14.59967143,-1.084901274,1.27088435,-3.223706643,-1.952822293
50,3,7,22,41,Louisiana,Franklin Parish,19774,19721,19668,-53,-53,51,258,47,294,4,-36,0,0,-57,-21,-57,-21,0,4,648,648,648,13.10010409,14.92802559,-1.827921501,0,-1.066287542,-1.066287542
50,3,7,22,43,Louisiana,Grant Parish,22169,22129,22236,-40,107,52,265,57,240,-5,25,0,8,-36,70,-36,78,1,4,2881,2881,2881,11.94635411,10.81933957,1.127014539,0.360644652,3.155640708,3.51628536
50,3,7,22,45,Louisiana,Iberia Parish,69929,69725,68975,-204,-750,220,884,237,857,-17,27,0,22,-188,-798,-188,-776,1,-1,847,847,847,12.74693583,12.35760635,0.389329488,0.317231435,-11.50684932,-11.18961788
50,3,7,22,47,Louisiana,Iberville Parish,30241,30095,29824,-146,-271,63,345,87,402,-24,-57,0,1,-123,-216,-123,-215,1,1,3578,3578,3578,11.51554599,13.41811446,-1.902568467,0.033378394,-7.20973314,-7.176354746
50,3,7,22,49,Louisiana,Jackson Parish,15031,14989,14876,-42,-113,28,122,50,237,-22,-115,0,1,-19,0,-19,1,-1,1,871,871,871,8.170098778,15.8714214,-7.701322618,0.066968023,0,0.066968023
50,3,7,22,51,Louisiana,Jefferson Parish,440781,439845,433688,-936,-6157,1347,5422,1297,5246,50,176,55,758,-1032,-7029,-977,-6271,-9,-62,3159,3159,3159,12.41395574,12.01099443,0.402961308,1.735481087,-16.09326723,-14.35778614
50,3,7,22,53,Louisiana,Jefferson Davis Parish,32250,32166,32345,-84,179,90,406,117,446,-27,-40,0,4,-57,212,-57,216,0,3,537,537,537,12.58700067,13.82709925,-1.240098588,0.124009859,6.572522516,6.696532374
50,3,7,22,55,Louisiana,Lafayette Parish,241753,242004,244205,251,2201,679,3063,548,2380,131,683,0,175,114,1305,114,1480,6,38,4733,4733,4733,12.59951996,9.790028568,2.809491392,0.719855042,5.368061883,6.087916925
50,3,7,22,57,Louisiana,Lafourche Parish,97557,97495,97504,-62,9,280,1090,281,1126,-1,-36,0,32,-60,-11,-60,21,-1,24,1499,1499,1499,11.17954451,11.54877717,-0.369232663,0.328206811,-0.112821091,0.21538572
50,3,7,22,59,Louisiana,LaSalle Parish,14791,14812,14834,21,22,36,161,45,186,-9,-25,0,7,30,37,30,44,0,3,1137,1137,1137,10.86149902,12.54806719,-1.686568171,0.472239088,2.496120893,2.968359981
50,3,7,22,61,Louisiana,Lincoln Parish,48396,48259,48152,-137,-107,113,442,136,477,-23,-35,1,42,-117,-125,-116,-83,2,11,5024,5024,5024,9.169078217,9.895136447,-0.72605823,0.871269876,-2.593065107,-1.721795231
50,3,7,22,63,Louisiana,Livingston Parish,142282,142726,145830,444,3104,373,1708,341,1375,32,333,0,47,407,2749,407,2796,5,-25,1036,1036,1036,11.8382567,9.530212506,2.308044193,0.325759991,19.05349395,19.37925394
50,3,7,22,65,Louisiana,Madison Parish,10017,9927,9799,-90,-128,26,133,37,160,-11,-27,0,0,-79,-100,-79,-100,0,-1,1342,1342,1342,13.48474095,16.22224475,-2.737503802,0,-10.13890297,-10.13890297
50,3,7,22,67,Louisiana,Morehouse Parish,25629,25430,25025,-199,-405,68,290,124,427,-56,-137,0,3,-142,-270,-142,-267,-1,-1,758,758,758,11.49539193,16.92597364,-5.430581706,0.118917848,-10.70260628,-10.58368844
50,3,7,22,69,Louisiana,Natchitoches Parish,37515,37349,37026,-166,-323,106,429,132,476,-26,-47,-1,6,-140,-284,-141,-278,1,2,2062,2062,2062,11.53613445,12.8,-1.263865546,0.161344538,-7.63697479,-7.475630252
50,3,7,22,71,Louisiana,Orleans Parish,383997,383282,376971,-715,-6311,1007,4448,1033,4295,-26,153,0,297,-685,-6699,-685,-6402,-4,-62,12960,12960,12960,11.70136783,11.29887025,0.40249759,0.78131885,-17.62308074,-16.84176189
50,3,7,22,73,Louisiana,Ouachita Parish,160368,160003,158768,-365,-1235,471,1913,503,1969,-32,-56,0,35,-336,-1229,-336,-1194,3,15,5682,5682,5682,12.00234651,12.35369591,-0.351349401,0.219593376,-7.710864539,-7.491271163
50,3,7,22,75,Louisiana,Plaquemines Parish,23515,23466,23303,-49,-163,64,255,56,227,8,28,0,4,-59,-198,-59,-194,2,3,238,238,238,10.90465907,9.70728474,1.197374329,0.171053476,-8.467147042,-8.296093566
50,3,7,22,77,Louisiana,Pointe Coupee Parish,20758,20689,20356,-69,-333,58,246,79,326,-21,-80,0,4,-47,-255,-47,-251,-1,-2,63,63,63,11.98684371,15.88500426,-3.898160555,0.194908028,-12.42538677,-12.23047874
50,3,7,22,79,Louisiana,Rapides Parish,130023,129607,128654,-416,-953,371,1555,429,1781,-58,-226,0,33,-359,-776,-359,-743,1,16,4361,4361,4361,12.04208146,13.79224893,-1.750167466,0.255555427,-6.009424574,-5.753869148
50,3,7,22,81,Louisiana,Red River Parish,7620,7619,7564,-1,-55,38,97,25,116,13,-19,0,0,-14,-37,-14,-37,0,1,71,71,71,12.77744846,15.28024765,-2.502799183,0,-4.873872094,-4.873872094
50,3,7,22,83,Louisiana,Richland Parish,20043,19997,19805,-46,-192,63,229,74,294,-11,-65,0,2,-36,-129,-36,-127,1,0,950,950,950,11.50695945,14.77312698,-3.266167529,0.100497462,-6.482086327,-6.381588865
50,3,7,22,85,Louisiana,Sabine Parish,22155,22118,22135,-37,17,66,206,78,306,-12,-100,0,3,-25,114,-25,117,0,0,240,240,240,9.31010327,13.82957088,-4.519467607,0.135584028,5.152193072,5.2877771
50,3,7,22,87,Louisiana,St. Bernard Parish,43764,43838,44258,74,420,120,556,110,469,10,87,0,25,62,302,62,327,2,6,173,173,173,12.62259353,10.64747548,1.975118053,0.567562659,6.85615692,7.423719579
50,3,7,22,89,Louisiana,St. Charles Parish,52549,52481,52282,-68,-199,124,523,142,534,-18,-11,0,12,-52,-201,-52,-189,2,1,487,487,487,9.984441072,10.19443888,-0.209997805,0.229088514,-3.837232611,-3.608144097
50,3,7,22,91,Louisiana,St. Helena Parish,10920,10889,10912,-31,23,27,71,37,125,-10,-54,0,11,-19,64,-19,75,-2,2,117,117,117,6.513462685,11.46736388,-4.953901197,1.009128022,5.871290308,6.880418329
50,3,7,22,93,Louisiana,St. James Parish,20192,20127,19742,-65,-385,64,215,54,274,10,-59,0,2,-73,-326,-73,-324,-2,-2,127,127,127,10.78532193,13.74501492,-2.959692995,0.100328576,-16.3535579,-16.25322933
50,3,7,22,95,Louisiana,St. John the Baptist Parish,42477,42394,42094,-83,-300,139,511,127,494,12,17,0,20,-97,-341,-97,-321,2,4,380,380,380,12.09639239,11.69396837,0.402424013,0.473440015,-8.072152258,-7.598712243
50,3,7,22,97,Louisiana,St. Landry Parish,82540,82273,82071,-267,-202,257,1049,318,1242,-61,-193,0,11,-206,-34,-206,-23,0,14,984,984,984,12.76590566,15.11463759,-2.348731928,0.13386555,-0.413766246,-0.279900696
50,3,7,22,99,Louisiana,St. Martin Parish,51767,51604,51540,-163,-64,147,615,153,613,-6,2,0,8,-157,-84,-157,-76,0,10,557,557,557,11.92507562,11.88629489,0.038780734,0.155122935,-1.628790817,-1.473667882
50,3,7,22,101,Louisiana,St. Mary Parish,49406,49140,48232,-266,-908,157,615,169,622,-12,-7,-1,34,-252,-925,-253,-891,-1,-10,805,805,805,12.63196812,12.77574662,-0.143778499,0.698352709,-18.99930165,-18.30094894
50,3,7,22,103,Louisiana,St. Tammany Parish,264570,264933,269388,363,4455,649,2696,709,2991,-60,-295,3,123,428,4668,431,4791,-8,-41,1122,1122,1122,10.09131215,11.1955173,-1.10420515,0.460397402,17.47264285,17.93304025
50,3,7,22,105,Louisiana,Tangipahoa Parish,133157,133549,135217,392,1668,396,1863,369,1617,27,246,0,27,361,1386,361,1413,4,9,3350,3350,3350,13.86336069,12.032772,1.830588691,0.200918271,10.31380457,10.51472284
50,3,7,22,107,Louisiana,Tensas Parish,4147,4116,4043,-31,-73,14,43,18,77,-4,-34,0,0,-27,-38,-27,-38,0,-1,11,11,11,10.54050742,18.87486212,-8.3343547,0,-9.314867018,-9.314867018
50,3,7,22,109,Louisiana,Terrebonne Parish,109580,109319,108708,-261,-611,302,1301,303,1309,-1,-8,-1,43,-262,-661,-263,-618,3,15,1292,1292,1292,11.93430172,12.00768712,-0.073385406,0.394446559,-6.063469203,-5.669022644
50,3,7,22,111,Louisiana,Union Parish,21107,21124,21091,17,-33,61,243,71,331,-10,-88,0,9,28,43,28,52,-1,3,352,352,352,11.51249556,15.68162975,-4.169134194,0.426388724,2.037190572,2.463579297
50,3,7,22,113,Louisiana,Vermilion Parish,57359,57289,57204,-70,-85,168,686,167,709,1,-23,0,11,-71,-81,-71,-70,0,8,384,384,384,11.98326535,12.38503664,-0.401771287,0.192151485,-1.414933664,-1.222782179
50,3,7,22,115,Louisiana,Vernon Parish,48750,48582,48027,-168,-555,193,814,119,450,74,364,2,4,-247,-912,-245,-908,3,-11,3324,3324,3324,16.85143206,9.315902245,7.535529816,0.08280802,-18.88022855,-18.79742053
50,3,7,22,117,Louisiana,Washington Parish,45463,45370,45133,-93,-237,137,575,173,782,-36,-207,1,-1,-56,-37,-55,-38,-2,8,1446,1446,1446,12.7067611,17.2811951,-4.574433997,-0.022098715,-0.817652454,-0.839751168
50,3,7,22,119,Louisiana,Webster Parish,36967,36864,36184,-103,-680,115,468,161,565,-46,-97,0,5,-56,-582,-56,-577,-1,-6,1031,1031,1031,12.8134925,15.46928047,-2.655787975,0.136896287,-15.93472785,-15.79783156
50,3,7,22,121,Louisiana,West Baton Rouge Parish,27199,27236,27792,37,556,74,359,70,248,4,111,0,1,32,447,32,448,1,-3,534,534,534,13.04790289,9.01359308,4.034309806,0.036345133,16.24627462,16.28261976
50,3,7,22,123,Louisiana,West Carroll Parish,9751,9694,9594,-57,-100,35,99,41,169,-6,-70,0,2,-52,-33,-52,-31,1,1,292,292,292,10.26545002,17.52384903,-7.258399005,0.207382829,-3.421816674,-3.214433845
50,3,7,22,125,Louisiana,West Feliciana Parish,15310,15256,15494,-54,238,18,71,48,134,-30,-63,1,8,-24,294,-23,302,-1,-1,5258,5258,5258,4.617886179,8.715447155,-4.097560976,0.520325203,19.12195122,19.64227642
50,3,7,22,127,Louisiana,Winn Parish,13755,13721,13488,-34,-233,31,116,56,228,-25,-112,0,6,-9,-127,-9,-121,0,0,1673,1673,1673,8.526590466,16.75916057,-8.232570105,0.441030541,-9.335146459,-8.894115918
40,1,1,23,0,Maine,Maine,1362359,1362280,1372247,-79,9967,2957,11291,4507,17635,-1550,-6344,42,867,1530,15473,1572,16340,-101,-29,35169,35169,35169,8.258100944,12.89802587,-4.63992493,0.634113322,11.3167652,11.95087853
50,1,1,23,1,Maine,Androscoggin County,111139,111039,111034,-100,-5,270,1094,365,1384,-95,-290,1,87,-3,183,-2,270,-3,15,3135,3135,3135,9.852616032,12.46436982,-2.611753793,0.783526138,1.648106704,2.431632842
50,1,1,23,3,Maine,Aroostook County,67105,66994,66859,-111,-135,147,591,246,1093,-99,-502,0,21,-3,344,-3,365,-9,2,2092,2092,2092,8.830582804,16.33134857,-7.500765765,0.313777054,5.139966979,5.453744033
50,1,1,23,5,Maine,Cumberland County,303069,303312,305231,243,1919,697,2704,854,3324,-157,-620,27,455,384,2052,411,2507,-11,32,9295,9295,9295,8.886800111,10.92445398,-2.037653872,1.495375019,6.743977007,8.239352026
50,1,1,23,7,Maine,Franklin County,29456,29418,29687,-38,269,50,204,101,377,-51,-173,1,7,16,439,17,446,-4,-4,951,951,951,6.902969292,12.75695796,-5.853988664,0.236866593,14.85491921,15.09178581
50,1,1,23,9,Maine,Hancock County,55478,55460,56192,-18,732,125,370,193,777,-68,-407,1,13,57,1138,58,1151,-8,-12,861,861,861,6.62773618,13.91824598,-7.290509798,0.232866406,20.38476695,20.61763336
50,1,1,23,11,Maine,Kennebec County,123642,123754,124486,112,732,280,1048,414,1680,-134,-632,1,43,252,1321,253,1364,-7,0,3644,3644,3644,8.443441831,13.53528843,-5.0918466,0.34643893,10.6429262,10.98936513
50,1,1,23,13,Maine,Knox County,40607,40609,41084,2,475,60,276,133,558,-73,-282,0,14,81,752,81,766,-6,-9,1389,1389,1389,6.757004884,13.66090118,-6.903896295,0.342746625,18.41039012,18.75313674
50,1,1,23,15,Maine,Lincoln County,35237,35192,35828,-45,636,55,233,153,531,-98,-298,0,4,59,943,59,947,-6,-13,463,463,463,6.561531963,14.95353422,-8.392002253,0.112644326,26.55589975,26.66854407
50,1,1,23,17,Maine,Oxford County,57777,57849,58629,72,780,137,486,193,842,-56,-356,0,6,134,1142,134,1148,-6,-12,841,841,841,8.344923505,14.45766583,-6.11274232,0.103023747,19.60885317,19.71187692
50,1,1,23,19,Maine,Penobscot County,152199,152007,152765,-192,758,318,1164,526,2029,-208,-865,3,72,21,1549,24,1621,-8,2,7170,7170,7170,7.638496975,13.31487145,-5.67637447,0.472484349,10.16497579,10.63746013
50,1,1,23,21,Maine,Piscataquis County,16800,16768,17165,-32,397,16,117,78,258,-62,-141,3,12,30,534,33,546,-3,-8,198,198,198,6.895942003,15.20643621,-8.310494209,0.707276103,31.47378658,32.18106268
50,1,1,23,23,Maine,Sagadahoc County,36699,36688,37071,-11,383,77,296,114,470,-37,-174,0,7,31,552,31,559,-5,-2,240,240,240,8.026139183,12.74420749,-4.718068304,0.189807346,14.96766496,15.15747231
50,1,1,23,25,Maine,Somerset County,50477,50404,50592,-73,188,119,418,191,705,-72,-287,0,7,5,466,5,473,-6,2,650,650,650,8.277555547,13.96094895,-5.683393402,0.138619351,9.228088241,9.366707592
50,1,1,23,27,Maine,Waldo County,39607,39635,39912,28,277,96,334,133,525,-37,-191,0,10,69,459,69,469,-4,-1,518,518,518,8.397551133,13.19974355,-4.802192415,0.251423687,11.54034722,11.7917709
50,1,1,23,29,Maine,Washington County,31095,31062,31121,-33,59,71,249,168,527,-97,-278,2,13,65,325,67,338,-3,-1,272,272,272,8.008619719,16.94997025,-8.94135053,0.418120708,10.45301771,10.87113841
50,1,1,23,31,Maine,York County,211972,212089,214591,117,2502,439,1707,645,2555,-206,-848,3,96,332,3274,335,3370,-12,-20,3450,3450,3450,8.001312459,11.97618824,-3.974875785,0.449985938,15.34639543,15.79638136
40,3,5,24,0,Maryland,Maryland,6177224,6172679,6165129,-4545,-7550,16844,66906,15128,61654,1716,5252,516,6838,-6795,-19871,-6279,-13033,18,231,137754,137754,137754,10.84568669,9.994319899,0.851366791,1.108462703,-3.221155654,-2.112692952
50,3,5,24,1,Maryland,Allegany County,68106,67947,67729,-159,-218,170,609,270,1070,-100,-461,0,13,-54,220,-54,233,-5,10,7198,7198,7198,8.977269377,15.77287066,-6.795601285,0.191633008,3.243020136,3.434653144
50,3,5,24,3,Maryland,Anne Arundel County,588261,588769,590336,508,1567,1658,6484,1341,5641,317,843,-16,184,203,411,187,595,4,129,14037,14037,14037,10.99817234,9.568274242,1.429898101,0.312101128,0.697138932,1.009240059
50,3,5,24,5,Maryland,Baltimore County,854535,853073,849316,-1462,-3757,2237,9250,2579,10074,-342,-824,69,821,-1178,-3880,-1109,-3059,-11,126,21627,21627,21627,10.8670815,11.83513286,-0.968051368,0.964526909,-4.55830013,-3.593773221
50,3,5,24,9,Maryland,Calvert County,92783,92857,93928,74,1071,210,885,224,976,-14,-91,0,12,90,1156,90,1168,-2,-6,517,517,517,9.476135664,10.45051798,-0.974382311,0.128489975,12.3778676,12.50635758
50,3,5,24,11,Maryland,Caroline County,33293,33290,33386,-3,96,107,376,83,406,24,-30,0,16,-27,104,-27,120,0,6,341,341,341,11.27842102,12.17829504,-0.899874018,0.479932809,3.119563261,3.599496071
50,3,5,24,13,Maryland,Carroll County,172891,172890,173873,-1,983,417,1579,486,1933,-69,-354,1,38,72,1295,73,1333,-5,4,3303,3303,3303,9.107084666,11.14882499,-2.041740324,0.219169865,7.469078304,7.68824817
50,3,5,24,15,Maryland,Cecil County,103725,103740,103905,15,165,263,1137,314,1255,-51,-118,2,2,65,263,67,265,-1,18,1226,1226,1226,10.95138337,12.08793855,-1.136555178,0.019263647,2.533169592,2.552433239
50,3,5,24,17,Maryland,Charles County,166617,166682,168698,65,2016,407,1832,361,1474,46,358,-4,63,17,1589,13,1652,6,6,1297,1297,1297,10.92492099,8.790029221,2.134891765,0.375693244,9.475818475,9.851511718
50,3,5,24,19,Maryland,Dorchester County,32531,32508,32489,-23,-19,73,327,99,488,-26,-161,0,5,6,134,6,139,-3,3,453,453,453,10.06200286,15.01607767,-4.954074803,0.153853255,4.123267228,4.277120483
50,3,5,24,21,Maryland,Frederick County,271717,272737,279835,1020,7098,764,2783,580,2371,184,412,2,244,830,6515,832,6759,4,-73,4305,4305,4305,10.07289548,8.581687092,1.491208386,0.88314283,23.58063746,24.46378029
50,3,5,24,23,Maryland,Garrett County,28806,28761,28702,-45,-59,69,253,90,438,-21,-185,0,1,-21,121,-21,122,-3,4,453,453,453,8.805666255,15.24459217,-6.438925918,0.034805005,4.2114056,4.246210605
50,3,5,24,25,Maryland,Harford County,260924,261122,262977,198,1855,678,2582,684,2683,-6,-101,0,68,209,1874,209,1942,-5,14,2617,2617,2617,9.853100273,10.23852364,-0.385423365,0.259492958,7.151320647,7.410813606
50,3,5,24,27,Maryland,Howard County,332317,332722,334529,405,1807,833,3136,521,2266,312,870,12,288,76,599,88,887,5,50,1534,1534,1534,9.399761109,6.792046771,2.607714338,0.863243367,1.795426309,2.658669676
50,3,5,24,29,Maryland,Kent County,19198,19142,19270,-56,128,38,164,75,330,-37,-166,0,5,-16,291,-16,296,-3,-2,1430,1430,1430,8.53899823,17.18213058,-8.643132354,0.260335312,15.15151515,15.41185046
50,3,5,24,31,Maryland,Montgomery County,1062061,1061243,1054827,-818,-6416,2965,11367,1758,7706,1207,3661,272,2367,-2311,-12443,-2039,-10076,14,-1,8362,8362,8362,10.74350092,7.283312934,3.46018799,2.237166067,-11.76048051,-9.523314446
50,3,5,24,33,Maryland,Prince George's County,967201,965601,955306,-1600,-10295,2742,11328,1973,8244,769,3084,152,1857,-2550,-15142,-2398,-13285,29,-94,21021,21021,21021,11.79442836,8.583445216,3.210983145,1.933461641,-15.76546912,-13.83200748
50,3,5,24,35,Maryland,Queen Anne's County,49874,49983,50798,109,815,139,488,148,510,-9,-22,0,27,120,818,120,845,-2,-8,317,317,317,9.684365109,10.12095534,-0.43659023,0.535815283,16.23321856,16.76903385
50,3,5,24,37,Maryland,St. Mary's County,113777,113953,114468,176,515,330,1337,270,1067,60,270,-2,33,114,185,112,218,4,27,2561,2561,2561,11.70645431,9.342398466,2.364055844,0.288940159,1.619816041,1.9087562
50,3,5,24,39,Maryland,Somerset County,24620,24567,24584,-53,17,51,216,77,332,-26,-116,0,12,-27,119,-27,131,0,2,5005,5005,5005,8.789241318,13.50938943,-4.720148115,0.488291184,4.842220911,5.330512095
50,3,5,24,41,Maryland,Talbot County,37526,37456,37626,-70,170,83,312,142,605,-59,-293,0,14,-3,452,-3,466,-8,-3,320,320,320,8.310913401,16.11571349,-7.804800085,0.372925601,12.04016942,12.41309502
50,3,5,24,43,Maryland,Washington County,154705,154586,154937,-119,351,406,1555,507,1913,-101,-358,-1,60,-14,628,-15,688,-3,21,8374,8374,8374,10.04771859,12.36095541,-2.313236819,0.387693322,4.057856767,4.445550088
50,3,5,24,45,Maryland,Wicomico County,103588,103473,103980,-115,507,283,1327,317,1290,-34,37,2,123,-83,329,-81,452,0,18,4670,4670,4670,12.7932592,12.43655189,0.356707302,1.185810762,3.17180277,4.357613532
50,3,5,24,47,Maryland,Worcester County,52460,52445,53132,-15,687,84,274,205,756,-121,-482,-1,15,116,1169,115,1184,-9,-15,619,619,619,5.190524451,14.32130104,-9.13077659,0.284152798,22.14497476,22.42912756
50,3,5,24,510,Maryland,Baltimore city,585708,583132,576498,-2576,-6634,1837,7305,2024,7826,-187,-521,28,570,-2429,-6678,-2401,-6108,12,-5,26167,26167,26167,12.59884618,13.49740866,-0.898562473,0.983072187,-11.51746678,-10.53439459
40,1,1,25,0,Massachusetts,Massachusetts,7029917,7022220,6984723,-7697,-37497,16914,66197,17353,70431,-439,-4234,978,12675,-8152,-46187,-7174,-33512,-84,249,246722,246722,246722,9.452026756,10.05658408,-0.604557326,1.809816746,-6.594872272,-4.785055526
50,1,1,25,1,Massachusetts,Barnstable County,228996,228969,232411,-27,3442,362,1419,767,3360,-405,-1941,3,152,421,5296,424,5448,-46,-65,4238,4238,4238,6.151111882,14.56500065,-8.413888768,0.658892887,22.95721531,23.6161082
50,1,1,25,3,Massachusetts,Berkshire County,129026,128758,128657,-268,-101,251,865,423,1663,-172,-798,0,68,-81,616,-81,684,-15,13,5846,5846,5846,6.720665074,12.92076996,-6.200104889,0.52832974,4.786045879,5.314375619
50,1,1,25,5,Massachusetts,Bristol County,579200,579172,580164,-28,992,1390,5410,1684,6514,-294,-1104,24,462,257,1537,281,1999,-15,97,14921,14921,14921,9.332928504,11.23746696,-1.90453846,0.797007943,2.651517765,3.448525708
50,1,1,25,7,Massachusetts,Dukes County,20600,20581,21097,-19,516,43,182,45,167,-2,15,1,16,-15,489,-14,505,-3,-4,121,121,121,8.733624454,8.013820241,0.719804213,0.767791161,23.46561735,24.23340851
50,1,1,25,9,Massachusetts,Essex County,809829,809218,807074,-611,-2144,2031,8105,2112,8406,-81,-301,146,1700,-657,-3659,-511,-1959,-19,116,19391,19391,19391,10.0291284,10.40158585,-0.372457452,2.103580294,-4.527647232,-2.424066938
50,1,1,25,11,Massachusetts,Franklin County,71029,70988,71015,-41,27,118,483,202,869,-84,-386,0,25,51,383,51,408,-8,5,1433,1433,1433,6.802673183,12.23917805,-5.436504863,0.352105237,5.394252234,5.746357471
50,1,1,25,13,Massachusetts,Hampden County,465825,464908,462718,-917,-2190,1179,4695,1387,5619,-208,-924,37,391,-741,-1735,-704,-1344,-5,78,14058,14058,14058,10.12261407,12.11479627,-1.992182194,0.843012162,-3.740731717,-2.897719555
50,1,1,25,15,Massachusetts,Hampshire County,162308,162064,161572,-244,-492,211,937,416,1537,-205,-600,9,223,-43,-137,-34,86,-5,22,23067,23067,23067,5.790455944,9.498325279,-3.707869335,1.378091436,-0.846630165,0.531461271
50,1,1,25,17,Massachusetts,Middlesex County,1632002,1629422,1614742,-2580,-14680,4002,15629,3579,14205,423,1424,225,3878,-3254,-19998,-3029,-16120,26,16,55016,55016,55016,9.635147915,8.757263813,0.877884102,2.390754598,-12.32859991,-9.937845312
50,1,1,25,19,Massachusetts,Nantucket County,14255,14244,14491,-11,247,32,130,16,82,16,48,0,22,-27,176,-27,198,0,1,57,57,57,9.04819906,5.707325561,3.340873499,1.531233687,12.2498695,13.78110318
50,1,1,25,21,Massachusetts,Norfolk County,725981,726025,724505,44,-1520,1761,6919,1664,7135,97,-216,122,1208,-160,-2636,-38,-1428,-15,124,16547,16547,16547,9.539961256,9.837783431,-0.297822175,1.665598092,-3.634533584,-1.968935493
50,1,1,25,23,Massachusetts,Plymouth County,530819,530979,533003,160,2024,1325,4924,1418,5969,-93,-1045,41,514,236,2489,277,3003,-24,66,11238,11238,11238,9.255795681,11.22011463,-1.964318945,0.966181759,4.678650579,5.644832337
50,1,1,25,25,Massachusetts,Suffolk County,797936,795431,771245,-2505,-24186,2142,8436,1546,6326,596,2110,273,2966,-3417,-28850,-3144,-25884,43,-412,52366,52366,52366,10.76929755,8.07569657,2.693600974,3.786360422,-36.82956782,-33.0432074
50,1,1,25,27,Massachusetts,Worcester County,862111,861461,862029,-650,568,2067,8063,2094,8579,-27,-516,97,1050,-722,-158,-625,892,2,192,28423,28423,28423,9.356596209,9.955381232,-0.598785023,1.218457897,-0.183348903,1.035108994
40,2,3,26,0,Michigan,Michigan,10077331,10067664,10050811,-9667,-16853,26541,102983,29450,117336,-2909,-14353,295,4167,-6823,-7893,-6528,-3726,-230,1226,211749,211749,211749,10.23765469,11.6645024,-1.426847711,0.41424611,-0.784651918,-0.370405809
50,2,3,26,1,Michigan,Alcona County,10167,10158,10235,-9,77,14,51,59,211,-45,-160,0,0,37,243,37,243,-1,-6,77,77,77,5.001716275,20.69337518,-15.6916589,0,23.83170696,23.83170696
50,2,3,26,3,Michigan,Alger County,8842,8834,8821,-8,-13,16,55,27,140,-11,-85,0,2,5,69,5,71,-2,1,942,942,942,6.230529595,15.85952988,-9.629000283,0.226564713,7.816482583,8.043047295
50,2,3,26,5,Michigan,Allegan County,120502,120596,120950,94,354,304,1259,315,1263,-11,-4,0,32,107,303,107,335,-2,23,883,883,883,10.42451541,10.4576354,-0.033119985,0.264959883,2.508838896,2.77379878
50,2,3,26,7,Michigan,Alpena County,28907,28877,28893,-30,16,71,241,91,421,-20,-180,0,1,-6,193,-6,194,-4,2,476,476,476,8.343430847,14.57503895,-6.231608101,0.034620045,6.681668686,6.716288731
50,2,3,26,9,Michigan,Antrim County,23431,23421,23813,-10,392,39,151,97,315,-58,-164,0,4,50,562,50,566,-2,-10,177,177,177,6.393699454,13.33784985,-6.9441504,0.169369522,23.79641784,23.96578736
50,2,3,26,11,Michigan,Arenac County,15002,14990,14975,-12,-15,34,119,66,243,-32,-124,0,0,22,108,22,108,-2,1,166,166,166,7.9425997,16.21892208,-8.276322376,0,7.208409811,7.208409811
50,2,3,26,13,Michigan,Baraga County,8158,8128,8215,-30,87,13,50,36,143,-23,-93,0,0,-7,183,-7,183,0,-3,969,969,969,6.118827633,17.49984703,-11.3810194,0,22.39490914,22.39490914
50,2,3,26,15,Michigan,Barry County,62423,62548,62992,125,444,146,575,157,703,-11,-128,0,5,138,566,138,571,-2,1,553,553,553,9.160426956,11.19961765,-2.039190696,0.079655887,9.01704636,9.096702246
50,2,3,26,17,Michigan,Bay County,103856,103594,102985,-262,-609,230,875,418,1521,-188,-646,0,-1,-66,20,-66,19,-8,18,1347,1347,1347,8.471335421,14.72560134,-6.254265922,-0.009681526,0.193630524,0.183948998
50,2,3,26,19,Michigan,Benzie County,17970,17974,18223,4,249,33,171,72,271,-39,-100,0,0,45,354,45,354,-2,-5,210,210,210,9.44829682,14.9736166,-5.525319778,0,19.55963201,19.55963201
50,2,3,26,21,Michigan,Berrien County,154316,154095,153101,-221,-994,377,1564,509,2027,-132,-463,0,64,-80,-610,-80,-546,-9,15,3335,3335,3335,10.18242425,13.19678642,-3.014362166,0.416672092,-3.971405878,-3.554733786
50,2,3,26,23,Michigan,Branch County,44862,44810,44985,-52,175,135,522,171,543,-36,-21,1,24,-15,168,-14,192,-2,4,1858,1858,1858,11.62648254,12.0942146,-0.467732056,0.534550922,3.741856451,4.276407372
50,2,3,26,25,Michigan,Calhoun County,134310,134113,133819,-197,-294,326,1419,434,1769,-108,-350,0,43,-85,-11,-85,32,-4,24,4121,4121,4121,10.59223982,13.20484302,-2.612603198,0.320976964,-0.082110386,0.238866578
50,2,3,26,27,Michigan,Cass County,51589,51563,51483,-26,-80,136,449,138,680,-2,-231,0,4,-19,143,-19,147,-5,4,416,416,416,8.714554665,13.19798925,-4.483434583,0.077635231,2.775459504,2.853094734
50,2,3,26,29,Michigan,Charlevoix County,26054,26012,26086,-42,74,50,205,81,368,-31,-163,0,7,-9,230,-9,237,-2,0,218,218,218,7.869783869,14.12722177,-6.257437905,0.268724327,8.829513609,9.098237936
50,2,3,26,31,Michigan,Cheboygan County,25579,25599,25752,20,153,50,222,89,433,-39,-211,0,0,63,367,63,367,-4,-3,355,355,355,8.646374949,16.86432591,-8.217950965,0,14.29378201,14.29378201
50,2,3,26,33,Michigan,Chippewa County,36785,36744,36816,-41,72,72,291,104,444,-32,-153,0,3,-8,220,-8,223,-1,2,4518,4518,4518,7.911908646,12.07177814,-4.159869494,0.081566069,5.981511691,6.06307776
50,2,3,26,35,Michigan,Clare County,30856,30822,31065,-34,243,83,312,119,564,-36,-252,0,0,6,499,6,499,-4,-4,335,335,335,10.08289302,18.22676814,-8.143875127,0,16.12616543,16.12616543
50,2,3,26,37,Michigan,Clinton County,79128,79128,79426,0,298,201,734,186,761,15,-27,-1,11,-13,303,-14,314,-1,11,514,514,514,9.258675278,9.599253251,-0.340577973,0.138753989,3.822041702,3.960795691
50,2,3,26,39,Michigan,Crawford County,12988,12965,13204,-23,239,21,111,54,239,-33,-128,0,0,12,372,12,372,-2,-5,99,99,99,8.483319959,18.26588712,-9.78256716,0,28.43058581,28.43058581
50,2,3,26,41,Michigan,Delta County,36903,36842,36826,-61,-16,85,308,141,529,-56,-221,0,-1,0,204,0,203,-5,2,610,610,610,8.361839605,14.36173101,-5.999891405,-0.02714883,5.538361297,5.511212467
50,2,3,26,43,Michigan,Dickinson County,25947,25886,25787,-61,-99,60,206,80,350,-20,-144,0,3,-38,39,-38,42,-3,3,405,405,405,7.973216186,13.54672653,-5.573510344,0.116114799,1.509492385,1.625607184
50,2,3,26,45,Michigan,Eaton County,109175,109106,108944,-69,-162,268,1032,297,1296,-29,-264,0,36,-34,45,-34,81,-6,21,1648,1648,1648,9.465718872,11.88718184,-2.421462967,0.330199496,0.412749369,0.742948865
50,2,3,26,47,Michigan,Emmet County,34112,34090,34225,-22,135,72,240,106,434,-34,-194,0,1,17,328,17,329,-5,0,469,469,469,7.026275342,12.70584791,-5.679572568,0.029276147,9.602576301,9.631852448
50,2,3,26,49,Michigan,Genesee County,406211,405648,404208,-563,-1440,1071,4387,1477,5581,-406,-1194,-1,52,-145,-383,-146,-331,-11,85,5412,5412,5412,10.83402481,13.78269717,-2.948672357,0.128417892,-0.945847163,-0.817429271
50,2,3,26,51,Michigan,Gladwin County,25386,25369,25485,-17,116,48,232,99,445,-51,-213,0,0,37,332,37,332,-3,-3,231,231,231,9.124159358,17.50108153,-8.376922169,0,13.05698667,13.05698667
50,2,3,26,53,Michigan,Gogebic County,14380,14315,14361,-65,46,21,116,73,232,-52,-116,0,0,-10,164,-10,164,-3,-2,355,355,355,8.090389176,16.18077835,-8.090389176,0,11.43813642,11.43813642
50,2,3,26,55,Michigan,Grand Traverse County,95238,95315,95860,77,545,176,816,251,1079,-75,-263,0,18,158,786,158,804,-6,4,1439,1439,1439,8.536681051,11.28808683,-2.75140578,0.188309141,8.222832483,8.411141624
50,2,3,26,57,Michigan,Gratiot County,41761,41662,41544,-99,-118,103,393,154,557,-51,-164,0,3,-47,34,-47,37,-1,9,5525,5525,5525,9.446434151,13.38845756,-3.942023412,0.072110184,0.817248756,0.889358941
50,2,3,26,59,Michigan,Hillsdale County,45746,45677,45546,-69,-131,122,440,189,601,-67,-161,0,-1,2,23,2,22,-4,8,1607,1607,1607,9.64668998,13.17650154,-3.529811561,-0.021924295,0.504258794,0.482334499
50,2,3,26,61,Michigan,Houghton County,37361,37160,37313,-201,153,77,311,139,404,-62,-93,-1,12,-138,231,-139,243,0,3,2883,2883,2883,8.352020195,10.84956964,-2.497549447,0.322264445,6.203590563,6.525855008
50,2,3,26,63,Michigan,Huron County,31407,31351,31252,-56,-99,77,254,123,522,-46,-268,0,4,-6,163,-6,167,-4,2,486,486,486,8.114627095,16.6765171,-8.561890005,0.127789403,5.207418175,5.335207578
50,2,3,26,65,Michigan,Ingham County,284900,284520,284034,-380,-486,773,2937,710,2705,63,232,10,326,-463,-1097,-453,-771,10,53,16743,16743,16743,10.33147247,9.515367054,0.816105418,1.146768821,-3.858912258,-2.712143438
50,2,3,26,67,Michigan,Ionia County,66804,66861,67197,57,336,172,666,142,668,30,-2,0,7,27,321,27,328,0,10,5171,5171,5171,9.935997852,9.965835683,-0.029837831,0.10443241,4.788971938,4.893404347
50,2,3,26,69,Michigan,Iosco County,25237,25191,25369,-46,178,68,234,122,492,-54,-258,0,4,13,438,13,442,-5,-6,342,342,342,9.256329114,19.46202532,-10.2056962,0.158227848,17.32594937,17.48417722
50,2,3,26,71,Michigan,Iron County,11631,11637,11635,6,-2,30,97,55,221,-25,-124,0,0,34,122,34,122,-3,0,346,346,346,8.336198006,18.99278102,-10.65658302,0,10.48470265,10.48470265
50,2,3,26,73,Michigan,Isabella County,64394,64488,64813,94,325,133,598,113,583,20,15,-1,22,74,278,73,300,1,10,4205,4205,4205,9.249735114,9.017718347,0.232016767,0.340291258,4.300044083,4.640335342
50,2,3,26,75,Michigan,Jackson County,160366,160200,160050,-166,-150,437,1575,477,2025,-40,-450,0,15,-121,254,-121,269,-5,31,7734,7734,7734,9.836065574,12.64637002,-2.81030445,0.093676815,1.586260734,1.679937549
50,2,3,26,77,Michigan,Kalamazoo County,261670,261629,261108,-41,-521,746,2901,699,2650,47,251,6,161,-96,-973,-90,-812,2,40,7704,7704,7704,11.09927172,10.13894176,0.960329956,0.615988537,-3.722713334,-3.106724797
50,2,3,26,79,Michigan,Kalkaska County,17939,17925,17979,-14,54,56,162,70,235,-14,-73,0,0,1,127,1,127,-1,0,101,101,101,9.024064171,13.09046346,-4.066399287,0,7.074420677,7.074420677
50,2,3,26,81,Michigan,Kent County,657974,658040,658046,66,6,2093,7808,1538,5820,555,1988,17,379,-520,-2472,-503,-2093,14,111,10882,10882,10882,11.86548599,8.844406825,3.02107917,0.575950204,-3.756593414,-3.18064321
50,2,3,26,83,Michigan,Keweenaw County,2046,2055,2107,9,52,4,13,6,22,-2,-9,0,0,12,61,12,61,-1,0,9,9,9,6.246996636,10.57184046,-4.324843825,0,29.31283037,29.31283037
50,2,3,26,85,Michigan,Lake County,12096,12099,12308,3,209,30,94,45,209,-15,-115,0,1,22,327,22,328,-4,-4,105,105,105,7.702708239,17.12623428,-9.423526038,0.081943705,26.79559143,26.87753513
50,2,3,26,87,Michigan,Lapeer County,88619,88528,88513,-91,-15,188,765,283,1090,-95,-325,0,23,8,278,8,301,-4,9,1414,1414,1414,8.642065962,12.31353189,-3.671465932,0.25982682,3.140515474,3.400342294
50,2,3,26,89,Michigan,Leelanau County,22301,22302,22623,1,321,35,152,68,284,-33,-132,0,5,38,455,38,460,-4,-7,262,262,262,6.766833612,12.64329438,-5.876460768,0.222593211,20.25598219,20.4785754
50,2,3,26,91,Michigan,Lenawee County,99423,99214,98956,-209,-258,227,945,324,1270,-97,-325,0,31,-108,15,-108,46,-4,21,4912,4912,4912,9.537265984,12.8172781,-3.280012111,0.312862694,0.151385174,0.464247868
50,2,3,26,93,Michigan,Livingston County,193866,193973,195014,107,1041,470,1659,428,1929,42,-270,0,19,73,1277,73,1296,-8,15,1314,1314,1314,8.529848041,9.918069241,-1.3882212,0.09768964,6.565772121,6.663461761
50,2,3,26,95,Michigan,Luce County,5339,5325,5309,-14,-16,15,50,30,90,-15,-40,0,0,2,23,2,23,-1,1,887,887,887,9.403799135,16.92683844,-7.523039308,0,4.325747602,4.325747602
50,2,3,26,97,Michigan,Mackinac County,10834,10830,10906,-4,76,27,83,48,181,-21,-98,0,6,20,171,20,177,-3,-3,76,76,76,7.637099742,16.65439823,-9.017298491,0.552079499,15.73426573,16.28634523
50,2,3,26,99,Michigan,Macomb County,881217,880349,876792,-868,-3557,2265,8715,2671,10526,-406,-1811,34,250,-476,-2167,-442,-1917,-20,171,7114,7114,7114,9.919522679,11.98082567,-2.061302992,0.284553146,-2.466506672,-2.181953526
50,2,3,26,101,Michigan,Manistee County,25032,25063,25350,31,287,55,180,91,372,-36,-192,0,9,71,476,71,485,-4,-6,1284,1284,1284,7.141015214,14.75809811,-7.617082895,0.357050761,18.88401801,19.24106877
50,2,3,26,103,Michigan,Marquette County,66017,65931,66103,-86,172,141,505,196,794,-55,-289,0,6,-27,451,-27,457,-4,4,3767,3767,3767,7.649544814,12.02720511,-4.3776603,0.090885681,6.831573686,6.922459367
50,2,3,26,105,Michigan,Mason County,29052,29064,29383,12,319,72,257,79,412,-7,-155,0,2,22,477,22,479,-3,-5,362,362,362,8.794292265,14.09824285,-5.303950588,0.068438072,16.3224802,16.39091827
50,2,3,26,107,Michigan,Mecosta County,39714,39781,40031,67,250,105,381,103,476,2,-95,1,1,65,343,66,344,-1,1,2910,2910,2910,9.547436476,11.92803087,-2.380594397,0.025058888,8.595198717,8.620257605
50,2,3,26,109,Michigan,Menominee County,23502,23423,23299,-79,-124,36,191,87,311,-51,-120,0,0,-25,-6,-25,-6,-3,2,359,359,359,8.176019862,13.31278627,-5.136766406,0,-0.25683832,-0.25683832
50,2,3,26,111,Michigan,Midland County,83494,83476,83457,-18,-19,206,855,207,900,-1,-45,0,30,-13,-17,-13,13,-4,13,1185,1185,1185,10.24363068,10.78276914,-0.539138457,0.359425638,-0.203674528,0.15575111
50,2,3,26,113,Michigan,Missaukee County,15052,15067,15130,15,63,38,144,38,224,0,-80,0,1,16,141,16,142,-1,1,150,150,150,9.537371262,14.83591085,-5.29853959,0.066231745,9.338676027,9.404907772
50,2,3,26,115,Michigan,Monroe County,154809,154796,155274,-13,478,364,1453,456,1834,-92,-381,0,15,88,831,88,846,-9,13,1405,1405,1405,9.372077273,11.82958687,-2.457509595,0.096752346,5.360079982,5.456832328
50,2,3,26,117,Michigan,Montcalm County,66614,66515,67220,-99,705,158,626,212,786,-54,-160,0,2,-43,868,-43,870,-2,-5,2983,2983,2983,9.361797585,11.7545893,-2.392791715,0.029909896,12.98089505,13.01080495
50,2,3,26,119,Michigan,Montmorency County,9153,9155,9297,2,142,12,75,41,178,-29,-103,0,0,33,249,33,249,-2,-4,106,106,106,8.129200087,19.29330154,-11.16410145,0,26.98894429,26.98894429
50,2,3,26,121,Michigan,Muskegon County,175824,175817,176511,-7,694,464,1874,496,2180,-32,-306,0,24,29,956,29,980,-4,20,4568,4568,4568,10.63781476,12.37483254,-1.737017779,0.136236689,5.426761427,5.562998115
50,2,3,26,123,Michigan,Newaygo County,49978,50042,50296,64,254,131,491,165,620,-34,-129,1,2,100,378,101,380,-3,3,509,509,509,9.78692021,12.35822919,-2.571308976,0.039865255,7.534533278,7.574398533
50,2,3,26,125,Michigan,Oakland County,1274395,1272408,1270017,-1987,-2391,3179,12316,3257,13259,-78,-943,110,1150,-2001,-2855,-1891,-1705,-18,257,13629,13629,13629,9.688388055,10.43019951,-0.74181146,0.904648121,-2.245887293,-1.341239171
50,2,3,26,127,Michigan,Oceana County,26659,26688,26815,29,127,66,231,92,314,-26,-83,1,42,55,168,56,210,-1,0,239,239,239,8.635029811,11.73765957,-3.102629759,1.57000542,6.280021681,7.850027101
50,2,3,26,129,Michigan,Ogemaw County,20770,20740,20726,-30,-14,44,178,101,351,-57,-173,0,4,30,155,30,159,-3,0,184,184,184,8.585347031,16.92953263,-8.344185598,0.192929147,7.476004437,7.668933584
50,2,3,26,131,Michigan,Ontonagon County,5816,5804,5868,-12,64,7,24,28,114,-21,-90,0,1,10,156,10,157,-1,-3,75,75,75,4.112405757,19.53392735,-15.42152159,0.17135024,26.73063742,26.90198766
50,2,3,26,133,Michigan,Osceola County,22891,22887,23105,-4,218,55,243,72,318,-17,-75,0,1,14,295,14,296,-1,-3,366,366,366,10.56705514,13.82849191,-3.261436772,0.043485824,12.82831797,12.87180379
50,2,3,26,135,Michigan,Oscoda County,8219,8234,8311,15,77,22,58,25,147,-3,-89,0,0,19,169,19,169,-1,-3,40,40,40,7.011181626,17.76971895,-10.75853732,0,20.42913267,20.42913267
50,2,3,26,137,Michigan,Otsego County,25091,25102,25289,11,187,66,240,102,333,-36,-93,0,1,49,280,49,281,-2,-1,313,313,313,9.525510508,13.21664583,-3.691135322,0.039689627,11.11309559,11.15278522
50,2,3,26,139,Michigan,Ottawa County,296200,296787,299157,587,2370,817,3111,669,2499,148,612,14,122,425,1593,439,1715,0,43,8910,8910,8910,10.44057831,8.386694052,2.053884258,0.409434444,5.346139906,5.755574349
50,2,3,26,141,Michigan,Presque Isle County,12982,12979,13093,-3,114,14,67,57,223,-43,-156,0,0,43,274,43,274,-3,-4,210,210,210,5.139613378,17.10647438,-11.966861,0,21.0187174,21.0187174
50,2,3,26,143,Michigan,Roscommon County,23459,23432,23633,-27,201,41,141,123,461,-82,-320,0,1,60,530,60,531,-5,-10,200,200,200,5.991713588,19.58992882,-13.59821523,0.042494423,22.52204398,22.5645384
50,2,3,26,145,Michigan,Saginaw County,190124,189831,189591,-293,-240,502,2021,650,2545,-148,-524,-1,31,-135,227,-136,258,-9,26,6486,6486,6486,10.65304595,13.41514198,-2.76209603,0.163406445,1.196556868,1.359963313
50,2,3,26,147,Michigan,St. Clair County,160383,160265,160053,-118,-212,383,1458,558,2192,-175,-734,0,16,67,483,67,499,-10,23,1883,1883,1883,9.103453443,13.68639914,-4.582945698,0.099900724,3.015753095,3.115653819
50,2,3,26,149,Michigan,St. Joseph County,60939,60902,60758,-37,-144,190,694,193,779,-3,-85,1,17,-34,-88,-33,-71,-1,12,669,669,669,11.40884432,12.80618116,-1.39733684,0.279467368,-1.446654611,-1.167187243
50,2,3,26,151,Michigan,Sanilac County,40611,40506,40506,-105,0,106,380,120,602,-14,-222,0,12,-87,209,-87,221,-4,1,474,474,474,9.381326223,14.86199575,-5.48066953,0.296252407,5.159729423,5.45598183
50,2,3,26,153,Michigan,Schoolcraft County,8047,8041,8030,-6,-11,15,48,39,117,-24,-69,0,0,20,57,20,57,-2,1,110,110,110,5.973492627,14.56038828,-8.586895651,0,7.093522494,7.093522494
50,2,3,26,155,Michigan,Shiawassee County,68094,67983,67877,-111,-106,155,664,211,898,-56,-234,0,2,-51,114,-51,116,-4,12,756,756,756,9.774768144,13.21949065,-3.444722508,0.029442073,1.678198145,1.707640218
50,2,3,26,157,Michigan,Tuscola County,53323,53274,52917,-49,-357,119,484,189,802,-70,-318,0,2,26,-51,26,-49,-5,10,1030,1030,1030,9.115650102,15.10485823,-5.989208125,0.037667976,-0.960533379,-0.922865403
50,2,3,26,159,Michigan,Van Buren County,75587,75556,75658,-31,102,227,819,242,925,-15,-106,2,21,-14,175,-12,196,-4,12,765,765,765,10.83233034,12.23431693,-1.401986589,0.27775206,2.3146005,2.59235256
50,2,3,26,161,Michigan,Washtenaw County,372258,371656,369390,-602,-2266,895,3367,745,3020,150,347,15,375,-779,-3019,-764,-2644,12,31,21007,21007,21007,9.087155183,8.150641121,0.936514063,1.012082921,-8.147942233,-7.135859312
50,2,3,26,163,Michigan,Wayne County,1793561,1790225,1774816,-3336,-15409,5466,21470,5519,21853,-53,-383,87,701,-3390,-15857,-3303,-15156,20,130,22540,22540,22540,12.04474226,12.25960655,-0.214864289,0.393263359,-8.895830371,-8.502567011
50,2,3,26,165,Michigan,Wexford County,33673,33676,33901,3,225,90,372,106,408,-16,-36,0,1,21,259,21,260,-2,1,315,315,315,11.00966305,12.07511431,-1.065451263,0.029595868,7.66532992,7.694925788
40,2,4,27,0,Minnesota,Minnesota,5706494,5707165,5707390,671,225,16428,63065,13403,53578,3025,9487,171,4042,-2494,-13453,-2323,-9411,-31,149,123948,123948,123948,11.04992705,9.387663382,1.662263663,0.708218586,-2.357165917,-1.648947331
50,2,4,27,1,Minnesota,Aitkin County,15697,15693,15887,-4,194,32,95,68,285,-36,-190,0,1,36,390,36,391,-4,-7,211,211,211,6.016466118,18.04939835,-12.03293224,0.063331222,24.69917669,24.76250792
50,2,4,27,3,Minnesota,Anoka County,363887,364299,367018,412,2719,1054,3966,722,2825,332,1141,0,202,75,1326,75,1528,5,50,2826,2826,2826,10.84618572,7.725787859,3.120397858,0.552428017,3.626334408,4.178762425
50,2,4,27,5,Minnesota,Becker County,35183,35147,35219,-36,72,79,365,106,472,-27,-107,0,3,-6,173,-6,176,-3,3,411,411,411,10.37432851,13.41557002,-3.041241509,0.085268454,4.917147486,5.00241594
50,2,4,27,7,Minnesota,Beltrami County,46228,46230,46380,2,150,163,604,155,551,8,53,0,5,-6,83,-6,88,0,9,1785,1785,1785,13.04394774,11.89936292,1.144584818,0.1079797,1.792463017,1.900442717
50,2,4,27,9,Minnesota,Benton County,41379,41338,41459,-41,121,127,486,113,449,14,37,0,37,-57,38,-57,75,2,9,964,964,964,11.73955578,10.84580359,0.893752189,0.893752189,0.917907654,1.811659843
50,2,4,27,11,Minnesota,Big Stone County,5166,5147,5145,-19,-2,15,56,24,80,-9,-24,0,0,-10,22,-10,22,0,0,132,132,132,10.88223863,15.54605519,-4.663816557,0,4.275165177,4.275165177
50,2,4,27,13,Minnesota,Blue Earth County,69112,69173,69280,61,107,201,684,151,538,50,146,0,69,10,-122,10,-53,1,14,4126,4126,4126,9.880609304,7.771590359,2.109018945,0.996728132,-1.762330899,-0.765602768
50,2,4,27,15,Minnesota,Brown County,25912,25885,25819,-27,-66,67,230,73,335,-6,-105,0,3,-19,33,-19,36,-2,3,1109,1109,1109,8.896797153,12.95837846,-4.061581309,0.11604518,1.276496983,1.392542163
50,2,4,27,17,Minnesota,Carlton County,36207,36156,36409,-51,253,98,355,117,430,-19,-75,0,2,-31,324,-31,326,-1,2,1939,1939,1939,9.784331289,11.85144353,-2.067112244,0.055122993,8.929924895,8.985047888
50,2,4,27,19,Minnesota,Carver County,106922,107286,108626,364,1340,281,1098,142,718,139,380,-2,17,224,932,222,949,3,11,778,778,778,10.17081033,6.650857757,3.519952573,0.157471563,8.633146838,8.7906184
50,2,4,27,21,Minnesota,Cass County,30066,30125,30639,59,514,63,279,95,389,-32,-110,0,0,95,632,95,632,-4,-8,185,185,185,9.183068922,12.80363373,-3.620564808,0,20.80179053,20.80179053
50,2,4,27,23,Minnesota,Chippewa County,12598,12593,12357,-5,-236,37,136,37,166,0,-30,0,11,-5,-213,-5,-202,0,-4,232,232,232,10.90180361,13.30661323,-2.404809619,0.881763527,-17.0741483,-16.19238477
50,2,4,27,25,Minnesota,Chisago County,56621,56670,57469,49,799,161,551,135,487,26,64,0,9,24,726,24,735,-1,0,1575,1575,1575,9.654894471,8.533454823,1.121439648,0.157702451,12.72133101,12.87903346
50,2,4,27,27,Minnesota,Clay County,65318,65351,65574,33,223,218,801,120,587,98,214,-2,47,-68,-50,-70,-3,5,12,2877,2877,2877,12.23601299,8.96696582,3.269047164,0.717968303,-0.763796066,-0.045827764
50,2,4,27,29,Minnesota,Clearwater County,8524,8580,8576,56,-4,38,96,20,120,18,-24,0,1,38,19,38,20,0,0,69,69,69,11.19141991,13.98927489,-2.797854978,0.116577291,2.214968524,2.331545815
50,2,4,27,31,Minnesota,Cook County,5600,5592,5617,-8,25,9,28,17,53,-8,-25,0,4,0,48,0,52,0,-2,48,48,48,4.995985369,9.456686591,-4.460701222,0.713712196,8.564546347,9.278258542
50,2,4,27,33,Minnesota,Cottonwood County,11517,11489,11569,-28,80,29,134,61,163,-32,-29,0,2,5,108,5,110,-1,-1,221,221,221,11.62286408,14.13826004,-2.515395958,0.173475583,9.367681499,9.541157082
50,2,4,27,35,Minnesota,Crow Wing County,66123,66236,67270,113,1034,175,628,191,795,-16,-167,0,6,135,1207,135,1213,-6,-12,668,668,668,9.407816877,11.9095771,-2.501760221,0.089883601,18.08158435,18.17146795
50,2,4,27,37,Minnesota,Dakota County,439882,440317,442038,435,1721,1268,4940,786,3452,482,1488,3,236,-56,-85,-53,151,6,82,2696,2696,2696,11.19730721,7.824515076,3.37279213,0.534932085,-0.192666217,0.342265868
50,2,4,27,39,Minnesota,Dodge County,20867,20861,20935,-6,74,63,236,49,137,14,99,0,2,-22,-30,-22,-28,2,3,100,100,100,11.29294669,6.555651259,4.737295435,0.095702938,-1.435544071,-1.339841133
50,2,4,27,41,Minnesota,Douglas County,39006,39079,39238,73,159,121,391,124,512,-3,-121,0,3,79,274,79,277,-3,3,474,474,474,9.985060715,13.07506672,-3.090006001,0.076611719,6.997203672,7.073815391
50,2,4,27,43,Minnesota,Faribault County,13921,13888,13909,-33,21,32,132,50,192,-18,-60,0,0,-15,81,-15,81,0,0,305,305,305,9.49742778,13.81444041,-4.317012627,0,5.827967047,5.827967047
50,2,4,27,45,Minnesota,Fillmore County,21228,21246,21271,18,25,67,218,57,276,10,-58,0,3,9,77,9,80,-1,3,300,300,300,10.25472164,12.98304208,-2.728320437,0.141120023,3.62208058,3.763200602
50,2,4,27,47,Minnesota,Freeborn County,30895,30883,30749,-12,-134,86,302,97,411,-11,-109,0,11,2,-40,2,-29,-3,4,588,588,588,9.800103842,13.33722741,-3.537123572,0.356957425,-1.298026999,-0.941069574
50,2,4,27,49,Minnesota,Goodhue County,47582,47536,47968,-46,432,116,484,144,569,-28,-85,0,3,-15,514,-15,517,-3,0,807,807,807,10.13570112,11.91573128,-1.780030156,0.062824594,10.76394706,10.82677165
50,2,4,27,51,Minnesota,Grant County,6074,6080,6153,6,73,17,69,22,68,-5,1,0,0,11,73,11,73,0,-1,89,89,89,11.28096133,11.11746914,0.163492193,0,11.93493011,11.93493011
50,2,4,27,53,Minnesota,Hennepin County,1281565,1281267,1267416,-298,-13851,3819,14722,2729,10975,1090,3747,91,1396,-1494,-18903,-1403,-17507,15,-91,25061,25061,25061,11.55263326,8.612291132,2.94034213,1.095467738,-14.83354344,-13.7380757
50,2,4,27,55,Minnesota,Houston County,18843,18818,18778,-25,-40,56,182,67,222,-11,-40,0,3,-13,-5,-13,-2,-1,2,214,214,214,9.681881051,11.809767,-2.127885945,0.159591446,-0.265985743,-0.106394297
50,2,4,27,57,Minnesota,Hubbard County,21344,21380,21715,36,335,54,208,59,252,-5,-44,0,5,44,378,44,383,-3,-4,93,93,93,9.653092006,11.69509224,-2.042000232,0.232045481,17.54263836,17.77468384
50,2,4,27,59,Minnesota,Isanti County,41135,41383,41906,248,523,118,437,91,387,27,50,0,0,221,472,221,472,0,1,373,373,373,10.49358259,9.292943846,1.20063874,0,11.3340297,11.3340297
50,2,4,27,61,Minnesota,Itasca County,45014,44984,45070,-30,86,88,394,145,579,-57,-185,1,-1,31,271,32,270,-5,1,895,895,895,8.750305372,12.8589513,-4.108645924,-0.022208897,6.018611056,5.996402159
50,2,4,27,63,Minnesota,Jackson County,9989,9969,9990,-20,21,20,95,34,108,-14,-13,0,2,-6,30,-6,32,0,2,93,93,93,9.519515006,10.82218548,-1.302670474,0.200410842,3.006162633,3.206573476
50,2,4,27,65,Minnesota,Kanabec County,16032,16040,16159,8,119,42,148,52,210,-10,-62,0,2,19,181,19,183,-1,-2,167,167,167,9.192832076,13.04388335,-3.851051275,0.124227461,11.24258517,11.36681263
50,2,4,27,67,Minnesota,Kandiyohi County,43732,43685,43767,-47,82,160,550,123,469,37,81,0,68,-82,-75,-82,-7,-2,8,977,977,977,12.57832868,10.72588391,1.85244477,1.555138819,-1.715226639,-0.16008782
50,2,4,27,69,Minnesota,Kittson County,4207,4180,4146,-27,-34,6,42,17,85,-11,-43,0,2,-16,7,-16,9,0,0,89,89,89,10.08887821,20.41796781,-10.3290896,0.480422772,1.681479702,2.161902474
50,2,4,27,71,Minnesota,Koochiching County,12062,12031,11941,-31,-90,17,84,26,171,-9,-87,0,1,-19,-5,-19,-4,-3,1,199,199,199,7.008176206,14.26664442,-7.258468213,0.083430669,-0.417153346,-0.333722676
50,2,4,27,73,Minnesota,Lac qui Parle County,6719,6701,6684,-18,-17,27,63,24,118,3,-55,0,2,-20,36,-20,38,-1,0,138,138,138,9.4135226,17.63167725,-8.218154651,0.298841987,5.379155771,5.677997759
50,2,4,27,75,Minnesota,Lake County,10905,10885,10986,-20,101,21,101,51,157,-30,-56,0,0,11,159,11,159,-1,-2,203,203,203,9.235974578,14.35691098,-5.1209364,0,14.53980156,14.53980156
50,2,4,27,77,Minnesota,Lake of the Woods County,3763,3760,3823,-3,63,11,32,17,41,-6,-9,0,0,4,72,4,72,-1,0,44,44,44,8.439931426,10.81366214,-2.373730713,0,18.98984571,18.98984571
50,2,4,27,79,Minnesota,Le Sueur County,28674,28627,28841,-47,214,63,271,64,284,-1,-13,0,10,-46,217,-46,227,0,0,213,213,213,9.4313357,9.883761398,-0.452425698,0.348019768,7.552028955,7.900048723
50,2,4,27,81,Minnesota,Lincoln County,5640,5628,5567,-12,-61,13,66,14,83,-1,-17,0,1,-10,-44,-10,-43,-1,-1,116,116,116,11.79097812,14.82804824,-3.037070121,0.178651184,-7.860652077,-7.682000893
50,2,4,27,83,Minnesota,Lyon County,25269,25174,25231,-95,57,96,317,67,273,29,44,0,49,-124,-40,-124,9,0,4,793,793,793,12.57811725,10.8322587,1.745858546,1.944251562,-1.587144133,0.35710743
50,2,4,27,85,Minnesota,McLeod County,36771,36701,36735,-70,34,81,386,115,442,-34,-56,0,4,-34,79,-34,83,-2,7,442,442,442,10.51255515,12.03769269,-1.525137535,0.108938395,2.151533308,2.260471703
50,2,4,27,87,Minnesota,Mahnomen County,5411,5374,5414,-37,40,19,86,29,71,-10,15,0,0,-27,24,-27,24,0,1,65,65,65,15.94364108,13.16277345,2.780867631,0,4.449388209,4.449388209
50,2,4,27,89,Minnesota,Marshall County,9040,9035,8988,-5,-47,26,112,19,115,7,-3,0,0,-10,-46,-10,-46,-2,2,50,50,50,12.4285635,12.76147145,-0.332907951,0,-5.104588581,-5.104588581
50,2,4,27,91,Minnesota,Martin County,20025,19970,19915,-55,-55,54,221,65,247,-11,-26,0,0,-43,-32,-43,-32,-1,3,319,319,319,11.08186035,12.38560863,-1.303748276,0,-1.604613263,-1.604613263
50,2,4,27,93,Minnesota,Meeker County,23400,23428,23376,28,-52,58,251,60,274,-2,-23,0,3,32,-35,32,-32,-2,3,300,300,300,10.72557901,11.70840099,-0.982821981,0.128194171,-1.495598667,-1.367404495
50,2,4,27,95,Minnesota,Mille Lacs County,26459,26410,26867,-49,457,61,280,104,336,-43,-56,0,3,-4,516,-4,519,-2,-6,475,475,475,10.51110235,12.61332282,-2.10222047,0.112618954,19.37046005,19.483079
50,2,4,27,97,Minnesota,Morrison County,34010,33980,33992,-30,12,91,323,89,435,2,-112,0,1,-31,118,-31,119,-1,5,481,481,481,9.503913376,12.79938798,-3.295474607,0.02942388,3.47201789,3.50144177
50,2,4,27,99,Minnesota,Mower County,40029,40049,40158,20,109,143,474,96,412,47,62,1,74,-27,-33,-26,41,-1,6,540,540,540,11.81941726,10.27341753,1.545999726,1.845225479,-0.822870822,1.022354657
50,2,4,27,101,Minnesota,Murray County,8179,8168,8144,-11,-24,23,78,20,83,3,-5,-2,3,-12,-23,-14,-20,0,1,136,136,136,9.563511525,10.17655714,-0.613045611,0.367827366,-2.820009809,-2.452182442
50,2,4,27,103,Minnesota,Nicollet County,34454,34490,34332,36,-158,84,332,73,270,11,62,0,10,24,-231,24,-221,1,1,2797,2797,2797,9.64807765,7.846328209,1.801749441,0.290604749,-6.71296969,-6.422364941
50,2,4,27,105,Minnesota,Nobles County,22290,22183,21991,-107,-192,82,374,56,225,26,149,0,40,-133,-378,-133,-338,0,-3,366,366,366,16.93303753,10.18698782,6.746049713,1.811020057,-17.11413954,-15.30311948
50,2,4,27,107,Minnesota,Norman County,6441,6422,6416,-19,-6,11,63,19,86,-8,-23,0,3,-11,12,-11,15,0,2,128,128,128,9.814612868,13.3977255,-3.583112634,0.467362518,1.86945007,2.336812588
50,2,4,27,109,Minnesota,Olmsted County,162847,162991,163436,144,445,483,1976,301,1383,182,593,1,221,-38,-399,-37,-178,-1,30,2353,2353,2353,12.10684165,8.473563768,3.633277885,1.354054659,-2.444650718,-1.09059606
50,2,4,27,111,Minnesota,Otter Tail County,60081,60024,60046,-57,22,151,588,228,856,-77,-268,0,5,27,280,27,285,-7,5,1118,1118,1118,9.794286666,14.2583493,-4.46406263,0.083284751,4.663946032,4.747230782
50,2,4,27,113,Minnesota,Pennington County,13992,13939,13780,-53,-159,31,133,28,145,3,-12,0,2,-55,-149,-55,-147,-1,0,286,286,286,9.596305783,10.46213788,-0.865832101,0.14430535,-10.75074858,-10.60644323
50,2,4,27,115,Minnesota,Pine County,28876,28854,29302,-22,448,50,222,94,351,-44,-129,0,1,24,582,24,583,-2,-6,1427,1427,1427,7.634637871,12.0709815,-4.436343627,0.034390261,20.01513172,20.04952198
50,2,4,27,117,Minnesota,Pipestone County,9424,9405,9313,-19,-92,25,125,25,138,0,-13,0,7,-19,-85,-19,-78,0,-1,192,192,192,13.35612779,14.74516508,-1.38903729,0.747943156,-9.082166898,-8.334223742
50,2,4,27,119,Minnesota,Polk County,31192,31051,30757,-141,-294,85,359,96,411,-11,-52,-1,15,-128,-259,-129,-244,-1,2,1127,1127,1127,11.61661921,13.29924929,-1.68263008,0.485374062,-8.38079213,-7.895418069
50,2,4,27,121,Minnesota,Pope County,11308,11309,11403,1,94,21,123,37,124,-16,-1,0,2,19,92,19,94,-2,1,150,150,150,10.83127862,10.9193378,-0.088059176,0.176118352,8.101444171,8.277562522
50,2,4,27,123,Minnesota,Ramsey County,552352,551480,543257,-872,-8223,1815,6862,1307,5245,508,1617,73,737,-1464,-10478,-1391,-9741,11,-99,17063,17063,17063,12.53634435,9.582210156,2.954134189,1.346442114,-19.14249724,-17.79605513
50,2,4,27,125,Minnesota,Red Lake County,3935,3936,3933,1,-3,15,42,13,30,2,12,0,0,0,-15,0,-15,-1,0,19,19,19,10.67479985,7.624857034,3.049942814,0,-3.812428517,-3.812428517
50,2,4,27,127,Minnesota,Redwood County,15425,15391,15366,-34,-25,54,189,58,195,-4,-6,0,2,-29,-22,-29,-20,-1,1,343,343,343,12.28988523,12.68004032,-0.390155087,0.130051696,-1.430568651,-1.300516955
50,2,4,27,129,Minnesota,Renville County,14723,14684,14608,-39,-76,47,157,52,191,-5,-34,0,-3,-33,-42,-33,-45,-1,3,309,309,309,10.71965042,13.04110337,-2.321452956,-0.204834084,-2.867677181,-3.072511266
50,2,4,27,131,Minnesota,Rice County,67097,67030,67262,-67,232,153,671,148,610,5,61,1,81,-73,75,-72,156,0,15,7188,7188,7188,9.993149257,9.084681143,0.908468114,1.206326512,1.116968993,2.323295505
50,2,4,27,133,Minnesota,Rock County,9704,9705,9680,1,-25,28,77,25,134,3,-57,0,1,-2,29,-2,30,0,2,251,251,251,7.94428682,13.82512252,-5.880835698,0.103172556,2.992004127,3.095176683
50,2,4,27,135,Minnesota,Roseau County,15331,15294,15258,-37,-36,35,153,48,176,-13,-23,0,0,-24,-15,-24,-15,0,2,159,159,159,10.01571092,11.52134067,-1.505629746,0,-0.981932443,-0.981932443
50,2,4,27,137,Minnesota,St. Louis County,200231,199962,199182,-269,-780,477,1773,671,2486,-194,-713,-1,36,-61,-140,-62,-104,-13,37,8701,8701,8701,8.884011785,12.45665725,-3.572645461,0.180386026,-0.701501213,-0.521115186
50,2,4,27,139,Minnesota,Scott County,150928,151265,153268,337,2003,429,1612,262,903,167,709,-1,75,162,1201,161,1276,9,18,1161,1161,1161,10.58670161,5.93039178,4.656309825,0.492557457,7.887486742,8.380044199
50,2,4,27,141,Minnesota,Sherburne County,97183,97479,99074,296,1595,294,1155,198,725,96,430,0,23,195,1143,195,1166,5,-1,2012,2012,2012,11.75255529,7.377145096,4.375410195,0.234033569,11.63045082,11.86448439
50,2,4,27,143,Minnesota,Sibley County,14836,14802,14917,-34,115,45,159,30,146,15,13,0,5,-49,97,-49,102,0,0,196,196,196,10.70022545,9.825364245,0.8748612,0.336485077,6.527810492,6.864295569
50,2,4,27,145,Minnesota,Stearns County,158292,158349,158947,57,598,522,1957,368,1345,154,612,8,281,-106,-324,-98,-43,1,29,6483,6483,6483,12.33548485,8.477888155,3.857596692,1.771216782,-2.042257072,-0.27104029
50,2,4,27,147,Minnesota,Steele County,37406,37352,37349,-54,-3,93,382,106,359,-13,23,-1,8,-39,-39,-40,-31,-1,5,550,550,550,10.22744006,9.611651785,0.615788276,0.214187226,-1.044162729,-0.829975502
50,2,4,27,149,Minnesota,Stevens County,9671,9646,9700,-25,54,31,127,26,77,5,50,0,13,-29,-11,-29,2,-1,2,882,882,882,13.12932906,7.960301871,5.169027189,1.343947069,-1.137185982,0.206761088
50,2,4,27,151,Minnesota,Swift County,9838,9791,9749,-47,-42,24,107,32,130,-8,-23,0,3,-38,-23,-38,-20,-1,1,147,147,147,10.95189355,13.3060389,-2.354145343,0.307062436,-2.354145343,-2.047082907
50,2,4,27,153,Minnesota,Todd County,25262,25250,25237,-12,-13,76,293,66,244,10,49,1,9,-20,-76,-19,-67,-3,5,311,311,311,11.60694832,9.665854576,1.941093747,0.356527423,-3.010676016,-2.654148593
50,2,4,27,155,Minnesota,Traverse County,3360,3346,3286,-14,-60,10,36,12,40,-2,-4,0,1,-12,-56,-12,-55,0,-1,96,96,96,10.85645356,12.06272618,-1.206272618,0.301568154,-16.88781665,-16.58624849
50,2,4,27,157,Minnesota,Wabasha County,21387,21417,21509,30,92,61,214,49,217,12,-3,1,3,18,92,19,95,-1,0,179,179,179,9.97064716,10.11042259,-0.139775427,0.139775428,4.286446443,4.42622187
50,2,4,27,159,Minnesota,Wadena County,14065,14107,14177,42,70,55,204,50,183,5,21,0,6,37,42,37,48,0,1,450,450,450,14.42511667,12.94017819,1.484938481,0.424268138,2.969876962,3.3941451
50,2,4,27,161,Minnesota,Waseca County,18968,18954,19000,-14,46,60,186,55,160,5,26,0,4,-19,12,-19,16,0,4,948,948,948,9.801338462,8.431258892,1.37007957,0.210781472,0.632344417,0.843125889
50,2,4,27,163,Minnesota,Washington County,267568,268191,272256,623,4065,643,2694,534,2193,109,501,0,90,515,3490,515,3580,-1,-16,3310,3310,3310,9.969525226,8.115504388,1.854020838,0.333057636,12.91523498,13.24829262
50,2,4,27,165,Minnesota,Watonwan County,11253,11221,11135,-32,-86,38,172,35,159,3,13,0,12,-33,-111,-33,-99,-2,0,141,141,141,15.38736804,14.2243693,1.162998748,1.073537305,-9.930220075,-8.85668277
50,2,4,27,167,Minnesota,Wilkin County,6506,6481,6395,-25,-86,16,57,27,95,-11,-38,0,0,-14,-48,-14,-48,0,0,148,148,148,8.853681268,14.75613545,-5.902454178,0,-7.455731594,-7.455731594
50,2,4,27,169,Minnesota,Winona County,49671,49606,49630,-65,24,116,447,127,501,-11,-54,0,19,-53,50,-53,69,-1,9,3717,3717,3717,9.008827442,10.09714217,-1.088314724,0.382925551,1.007698819,1.39062437
50,2,4,27,171,Minnesota,Wright County,141337,141759,144845,422,3086,461,1653,274,1037,187,616,0,24,229,2460,229,2484,6,-14,1016,1016,1016,11.53507976,7.236465646,4.298614116,0.167478472,17.16654338,17.33402186
50,2,4,27,173,Minnesota,Yellow Medicine County,9528,9492,9411,-36,-81,23,104,20,119,3,-15,0,1,-39,-68,-39,-67,0,1,233,233,233,11.00354441,12.59059409,-1.587049675,0.105803312,-7.194625192,-7.08882188
40,3,6,28,0,Mississippi,Mississippi,2961279,2956870,2949965,-4409,-6905,8277,34957,9793,38194,-1516,-3237,6,441,-2886,-4246,-2880,-3805,-13,137,84333,84333,84333,11.83611867,12.93213709,-1.096018426,0.149318544,-1.437656545,-1.288338002
50,3,6,28,1,Mississippi,Adams County,29538,29405,28742,-133,-663,68,323,116,508,-48,-185,-7,11,-77,-484,-84,-473,-1,-5,2133,2133,2133,11.10977351,17.47295647,-6.363182967,0.37835142,-16.64746247,-16.26911105
50,3,6,28,3,Mississippi,Alcorn County,34740,34680,34349,-60,-331,89,388,133,556,-44,-168,0,6,-15,-172,-15,-166,-1,3,593,593,593,11.24165206,16.10917151,-4.867519448,0.17383998,-4.983412769,-4.809572788
50,3,6,28,5,Mississippi,Amite County,12720,12698,12637,-22,-61,34,121,42,200,-8,-79,0,0,-11,16,-11,16,-3,2,107,107,107,9.552003158,15.78843497,-6.236431814,0,1.263074798,1.263074798
50,3,6,28,7,Mississippi,Attala County,17889,17828,17742,-61,-86,48,229,75,310,-27,-81,0,2,-33,-10,-33,-8,-1,3,263,263,263,12.87601912,17.43041889,-4.554399775,0.112454315,-0.562271577,-0.449817262
50,3,6,28,9,Mississippi,Benton County,7646,7661,7646,15,-15,22,89,29,133,-7,-44,0,-1,23,29,23,28,-1,1,20,20,20,11.62866662,17.37767035,-5.749003724,-0.130659176,3.789116091,3.658456915
50,3,6,28,11,Mississippi,Bolivar County,30985,30849,30308,-136,-541,97,421,99,486,-2,-65,0,0,-135,-472,-135,-472,1,-4,1311,1311,1311,13.76784342,15.89351996,-2.125676537,0,-15.43568193,-15.43568193
50,3,6,28,13,Mississippi,Calhoun County,13266,13240,13018,-26,-222,38,177,39,218,-1,-41,0,-1,-24,-178,-24,-179,-1,-2,120,120,120,13.48160561,16.6044634,-3.122857796,-0.076167263,-13.55777287,-13.63394013
50,3,6,28,15,Mississippi,Carroll County,9998,9941,9879,-57,-62,16,95,32,128,-16,-33,0,0,-39,-30,-39,-30,-2,1,354,354,354,9.586276488,12.91624622,-3.329969728,0,-3.027245207,-3.027245207
50,3,6,28,17,Mississippi,Chickasaw County,17106,17067,17011,-39,-56,43,236,60,219,-17,17,0,-1,-21,-72,-21,-73,-1,0,445,445,445,13.85057809,12.85286695,0.997711133,-0.05868889,-4.225600094,-4.284288984
50,3,6,28,19,Mississippi,Choctaw County,8246,8202,8106,-44,-96,17,82,38,146,-21,-64,0,0,-23,-33,-23,-33,0,1,110,110,110,10.05641403,17.90532254,-7.848908511,0,-4.047093451,-4.047093451
50,3,6,28,21,Mississippi,Claiborne County,9135,9093,8908,-42,-185,27,100,45,131,-18,-31,0,1,-24,-154,-24,-153,0,-1,1301,1301,1301,11.11049386,14.55474696,-3.444253097,0.111104939,-17.11016055,-16.99905561
50,3,6,28,23,Mississippi,Clarke County,15615,15533,15421,-82,-112,32,170,66,236,-34,-66,0,-1,-47,-46,-47,-47,-1,1,45,45,45,10.98404084,15.24843316,-4.264392324,-0.064612005,-2.972152226,-3.036764231
50,3,6,28,25,Mississippi,Clay County,18636,18645,18535,9,-110,61,247,52,250,9,-3,0,2,1,-109,1,-107,-1,0,164,164,164,13.28671329,13.44809037,-0.161377084,0.107584723,-5.863367402,-5.755782679
50,3,6,28,27,Mississippi,Coahoma County,21390,21232,20810,-158,-422,65,332,83,342,-18,-10,0,1,-141,-408,-141,-407,1,-5,637,637,637,15.79373008,16.26944484,-0.475714761,0.047571476,-19.40916227,-19.36159079
50,3,6,28,29,Mississippi,Copiah County,28368,28293,27995,-75,-298,81,340,76,388,5,-48,1,8,-80,-258,-79,-250,-1,0,946,946,946,12.08072769,13.78624218,-1.705514497,0.284252416,-9.167140421,-8.882888005
50,3,6,28,31,Mississippi,Covington County,18340,18313,18279,-27,-34,49,220,68,286,-19,-66,0,0,-8,29,-8,29,0,3,179,179,179,12.02448623,15.63183209,-3.607345868,0,1.585045912,1.585045912
50,3,6,28,33,Mississippi,DeSoto County,185314,185902,188633,588,2731,518,2022,523,1753,-5,269,2,17,585,2453,587,2470,6,-8,470,470,470,10.79738876,9.3609409,1.436447862,0.090779233,13.09890931,13.18968855
50,3,6,28,35,Mississippi,Forrest County,78158,78136,77875,-22,-261,244,1009,216,923,28,86,1,29,-54,-386,-53,-357,3,10,2838,2838,2838,12.93498535,11.83249899,1.102486363,0.371768657,-4.948369025,-4.576600368
50,3,6,28,37,Mississippi,Franklin County,7675,7653,7676,-22,23,17,82,30,113,-13,-31,0,0,-9,55,-9,55,0,-1,52,52,52,10.69867571,14.74329702,-4.044621306,0,7.175941027,7.175941027
50,3,6,28,39,Mississippi,George County,24350,24335,24762,-15,427,86,317,90,324,-4,-7,0,4,-11,433,-11,437,0,-3,515,515,515,12.91321262,13.19836243,-0.285149805,0.162942746,17.63855225,17.801495
50,3,6,28,41,Mississippi,Greene County,13530,13501,13630,-29,129,20,128,39,138,-19,-10,0,2,-10,137,-10,139,0,0,2512,2512,2512,9.435700859,10.17286499,-0.73716413,0.147432826,10.09914858,10.2465814
50,3,6,28,43,Mississippi,Grenada County,21629,21581,21365,-48,-216,63,247,84,337,-21,-90,0,0,-27,-128,-27,-128,0,2,221,221,221,11.50281749,15.69412751,-4.191310017,0,-5.960974247,-5.960974247
50,3,6,28,45,Mississippi,Hancock County,46053,46075,46055,22,-20,93,469,163,612,-70,-143,0,-1,96,117,96,116,-4,7,409,409,409,10.1812656,13.28557473,-3.104309128,-0.021708455,2.539889287,2.518180831
50,3,6,28,47,Mississippi,Harrison County,208621,208613,209396,-8,783,583,2551,707,2523,-124,28,7,46,108,665,115,711,1,44,4884,4884,4884,12.20547883,12.07151042,0.133968407,0.220090955,3.181749675,3.40184063
50,3,6,28,49,Mississippi,Hinds County,227742,226636,222679,-1106,-3957,702,2854,735,2648,-33,206,-1,50,-1079,-4177,-1080,-4127,7,-36,7712,7712,7712,12.70378242,11.78683107,0.916951359,0.22256101,-18.59274674,-18.37018573
50,3,6,28,51,Mississippi,Holmes County,17000,16912,16496,-88,-416,57,193,70,266,-13,-73,0,0,-73,-340,-73,-340,-2,-3,804,804,804,11.55411877,15.9243295,-4.370210728,0,-20.35440613,-20.35440613
50,3,6,28,53,Mississippi,Humphreys County,7785,7715,7551,-70,-164,20,89,42,122,-22,-33,0,-1,-47,-130,-47,-131,-1,0,50,50,50,11.65989781,15.98323071,-4.323332897,-0.131010088,-17.03131141,-17.1623215
50,3,6,28,55,Mississippi,Issaquena County,1338,1326,1280,-12,-46,3,7,4,21,-1,-14,0,0,-11,-31,-11,-31,0,-1,285,285,285,5.372217959,16.11665388,-10.74443592,0,-23.79125096,-23.79125096
50,3,6,28,57,Mississippi,Itawamba County,23863,23824,23838,-39,14,59,237,111,356,-52,-119,0,0,13,130,13,130,0,3,862,862,862,9.945029583,14.93852545,-4.993495867,0,5.455079518,5.455079518
50,3,6,28,59,Mississippi,Jackson County,143252,143291,143987,39,696,393,1509,436,1839,-43,-330,6,78,78,935,84,1013,-2,13,1167,1167,1167,10.50550338,12.80292957,-2.297426186,0.543028008,6.509374195,7.052402203
50,3,6,28,61,Mississippi,Jasper County,16367,16348,16291,-19,-57,48,202,62,231,-14,-29,0,0,-4,-31,-4,-31,-1,3,70,70,70,12.3778302,14.15484543,-1.777015227,0,-1.899568001,-1.899568001
50,3,6,28,63,Mississippi,Jefferson County,7260,7254,7205,-6,-49,18,88,15,74,3,14,0,-1,-9,-60,-9,-61,0,-2,361,361,361,12.1723494,10.23583927,1.936510132,-0.138322152,-8.299329138,-8.43765129
50,3,6,28,65,Mississippi,Jefferson Davis County,11321,11258,11134,-63,-124,24,106,47,187,-23,-81,0,0,-39,-44,-39,-44,-1,1,104,104,104,9.467667024,16.70239371,-7.234726688,0,-3.929974991,-3.929974991
50,3,6,28,67,Mississippi,Jones County,67246,67142,66744,-104,-398,222,861,239,946,-17,-85,0,-11,-86,-310,-86,-321,-1,8,1684,1684,1684,12.8616883,14.13142524,-1.26973694,-0.164318898,-4.630805312,-4.79512421
50,3,6,28,69,Mississippi,Kemper County,8988,8983,8829,-5,-154,20,94,24,136,-4,-42,0,0,-1,-112,-1,-112,0,0,660,660,660,10.55468224,15.27060409,-4.71592185,0,-12.5757916,-12.5757916
50,3,6,28,71,Mississippi,Lafayette County,55813,55905,56884,92,979,130,522,122,502,8,20,0,6,81,958,81,964,3,-5,4387,4387,4387,9.256221795,8.901577282,0.354644513,0.106393354,16.98747218,17.09386554
50,3,6,28,73,Mississippi,Lamar County,64222,64368,65353,146,985,172,722,127,525,45,197,0,17,100,770,100,787,1,1,320,320,320,11.1315824,8.094294679,3.037287718,0.262100971,11.8716322,12.13373317
50,3,6,28,75,Mississippi,Lauderdale County,72984,72706,72088,-278,-618,209,861,275,1036,-66,-175,3,0,-215,-451,-212,-451,0,8,3466,3466,3466,11.89275799,14.30998522,-2.417227233,0,-6.229539898,-6.229539898
50,3,6,28,77,Mississippi,Lawrence County,12016,11984,11812,-32,-172,35,135,41,181,-6,-46,0,-1,-26,-125,-26,-126,0,0,0,0,0,11.34644478,15.21264078,-3.866195999,-0.084047739,-10.50596739,-10.59001513
50,3,6,28,79,Mississippi,Leake County,21275,21247,21196,-28,-51,80,303,77,343,3,-40,0,-1,-31,-15,-31,-16,0,5,1455,1455,1455,14.27797281,16.16285371,-1.884880899,-0.047122022,-0.706830337,-0.75395236
50,3,6,28,81,Mississippi,Lee County,83343,83228,82883,-115,-345,223,1041,263,1171,-40,-130,1,36,-77,-266,-76,-230,1,15,808,808,808,12.53378765,14.09900609,-1.565218438,0.433445106,-3.202677728,-2.769232622
50,3,6,28,83,Mississippi,Leflore County,28339,28196,27557,-143,-639,81,409,116,401,-35,8,0,9,-109,-647,-109,-638,1,-9,1197,1197,1197,14.67185622,14.38487615,0.286980073,0.322852582,-23.20951339,-22.88666081
50,3,6,28,85,Mississippi,Lincoln County,34907,34815,34943,-92,128,94,340,153,434,-59,-94,0,2,-33,217,-33,219,0,3,607,607,607,9.747985894,12.44301729,-2.695031394,0.057341094,6.221508644,6.278849738
50,3,6,28,87,Mississippi,Lowndes County,58879,58726,58150,-153,-576,177,742,220,761,-43,-19,-1,9,-108,-570,-109,-561,-1,4,1119,1119,1119,12.69721756,13.02234847,-0.325130908,0.154009378,-9.753927239,-9.599917862
50,3,6,28,89,Mississippi,Madison County,109145,109222,109813,77,591,307,1357,306,1376,1,-19,0,25,74,564,74,589,2,21,1690,1690,1690,12.39071381,12.56420207,-0.173488255,0.22827402,5.149861894,5.378135914
50,3,6,28,91,Mississippi,Marion County,24441,24399,24378,-42,-21,75,282,99,408,-24,-126,0,0,-17,101,-17,101,-1,4,710,710,710,11.56282674,16.72919614,-5.166369395,0,4.141296103,4.141296103
50,3,6,28,93,Mississippi,Marshall County,33752,33754,33725,2,-29,104,366,126,543,-22,-177,0,0,25,146,25,146,-1,2,1562,1562,1562,10.84781932,16.09389588,-5.246076557,0,4.327272188,4.327272188
50,3,6,28,95,Mississippi,Monroe County,34180,34093,33883,-87,-210,87,394,152,525,-65,-131,0,0,-20,-84,-20,-84,-2,5,269,269,269,11.5923267,15.44662822,-3.854301518,0,-2.471460515,-2.471460515
50,3,6,28,97,Mississippi,Montgomery County,9822,9793,9729,-29,-64,28,116,36,172,-8,-56,0,-1,-19,-9,-19,-10,-2,2,81,81,81,11.88402828,17.62114537,-5.737117099,-0.10244852,-0.922036677,-1.024485196
50,3,6,28,99,Mississippi,Neshoba County,29087,28992,28993,-95,1,77,444,125,433,-48,11,0,1,-47,-16,-47,-15,0,5,290,290,290,15.31430542,14.93489696,0.379408468,0.034491679,-0.551866862,-0.517375183
50,3,6,28,101,Mississippi,Newton County,21291,21243,21056,-48,-187,61,260,74,334,-13,-74,0,0,-34,-115,-34,-115,-1,2,525,525,525,12.29343483,15.79233552,-3.498900683,0,-5.437480792,-5.437480792
50,3,6,28,103,Mississippi,Noxubee County,10285,10231,10123,-54,-108,38,144,41,148,-3,-4,0,-1,-51,-103,-51,-104,0,0,133,133,133,14.14955291,14.54259605,-0.393043136,-0.098260784,-10.12086076,-10.21912155
50,3,6,28,105,Mississippi,Oktibbeha County,51788,51710,51842,-78,132,122,496,85,431,37,65,1,48,-118,6,-117,54,2,13,4879,4879,4879,9.579728059,8.324320148,1.255407911,0.927070457,0.115883807,1.042954265
50,3,6,28,107,Mississippi,Panola County,33208,33114,32851,-94,-263,107,449,129,500,-22,-51,-1,-2,-70,-215,-71,-217,-1,5,238,238,238,13.61327977,15.15955431,-1.54627454,-0.060638217,-6.518608353,-6.57924657
50,3,6,28,109,Mississippi,Pearl River County,56145,56140,56503,-5,363,145,598,233,800,-88,-202,0,-2,85,567,85,565,-2,0,1155,1155,1155,10.61761494,14.20416715,-3.586552205,-0.035510418,10.06720347,10.03169305
50,3,6,28,111,Mississippi,Perry County,11511,11470,11571,-41,101,30,128,37,152,-7,-24,0,0,-34,124,-34,124,0,1,45,45,45,11.11062888,13.19387179,-2.083242915,0,10.76342173,10.76342173
50,3,6,28,113,Mississippi,Pike County,40324,40209,39973,-115,-236,114,476,142,605,-28,-129,0,0,-87,-113,-87,-113,0,6,920,920,920,11.87298895,15.09066873,-3.217679779,0,-2.818587713,-2.818587713
50,3,6,28,115,Mississippi,Pontotoc County,31184,31206,31445,22,239,115,421,98,324,17,97,0,0,5,136,5,136,0,6,151,151,151,13.4395301,10.34301129,3.096518811,0,4.34151091,4.34151091
50,3,6,28,117,Mississippi,Prentiss County,25008,24935,24996,-73,61,55,263,120,315,-65,-52,0,15,-8,96,-8,111,0,2,657,657,657,10.53453766,12.61741203,-2.082874367,0.600829144,3.845306523,4.446135667
50,3,6,28,119,Mississippi,Quitman County,6176,6153,5935,-23,-218,9,68,28,96,-19,-28,0,1,-4,-189,-4,-188,0,-2,58,58,58,11.25082727,15.88352085,-4.63269358,0.165453342,-31.27068167,-31.10522833
50,3,6,28,121,Mississippi,Rankin County,157031,157052,158096,21,1044,378,1681,379,1522,-1,159,-1,-2,25,867,24,865,-2,20,6270,6270,6270,10.66800361,9.658953888,1.009049716,-0.012692449,5.502176755,5.489484306
50,3,6,28,123,Mississippi,Scott County,27990,27958,27598,-32,-360,119,456,82,343,37,113,0,10,-70,-478,-70,-468,1,-5,124,124,124,16.41586867,12.34790122,4.067967456,0.35999712,-17.20786234,-16.84786522
50,3,6,28,125,Mississippi,Sharkey County,3800,3767,3663,-33,-104,11,43,9,51,2,-8,0,0,-35,-94,-35,-94,0,-2,35,35,35,11.57469717,13.72812921,-2.153432032,0,-25.30282638,-25.30282638
50,3,6,28,127,Mississippi,Simpson County,25949,25893,25750,-56,-143,76,323,85,377,-9,-54,-1,7,-46,-98,-47,-91,0,2,391,391,391,12.50895572,14.60023624,-2.091280522,0.27109192,-3.795286873,-3.524194954
50,3,6,28,129,Mississippi,Smith County,14209,14204,14191,-5,-13,52,186,44,226,8,-40,0,0,-11,26,-11,26,-2,1,53,53,53,13.10089805,15.91829548,-2.817397429,0,1.831308329,1.831308329
50,3,6,28,131,Mississippi,Stone County,18333,18333,18644,0,311,48,226,58,231,-10,-5,0,0,10,317,10,317,0,-1,1206,1206,1206,12.2238148,12.49425318,-0.270438381,0,17.14579333,17.14579333
50,3,6,28,133,Mississippi,Sunflower County,25971,25826,25402,-145,-424,54,286,107,352,-53,-66,0,0,-93,-355,-93,-355,1,-3,4202,4202,4202,11.16576872,13.74248458,-2.576715859,0,-13.85960803,-13.85960803
50,3,6,28,135,Mississippi,Tallahatchie County,12715,12670,12366,-45,-304,47,123,40,176,7,-53,0,1,-53,-249,-53,-248,1,-3,2178,2178,2178,9.825850775,14.05975395,-4.233903179,0.079884966,-19.89135645,-19.81147148
50,3,6,28,137,Mississippi,Tate County,28064,28124,28234,60,110,85,360,84,361,1,-1,0,-1,59,107,59,106,0,5,959,959,959,12.7754711,12.81095852,-0.03548742,-0.03548742,3.797153909,3.761666489
50,3,6,28,139,Mississippi,Tippah County,21815,21732,21635,-83,-97,53,244,73,298,-20,-54,0,-3,-63,-44,-63,-47,0,4,284,284,284,11.25279591,13.74316877,-2.490372864,-0.138354048,-2.029192704,-2.167546752
50,3,6,28,141,Mississippi,Tishomingo County,18850,18822,18750,-28,-72,57,183,89,329,-32,-146,0,0,5,73,5,73,-1,1,200,200,200,9.74129671,17.51304163,-7.771744916,0,3.885872458,3.885872458
50,3,6,28,143,Mississippi,Tunica County,9782,9720,9696,-62,-24,36,143,30,100,6,43,0,0,-69,-68,-69,-68,1,1,101,101,101,14.73011949,10.30078286,4.42933663,0,-7.004532344,-7.004532344
50,3,6,28,145,Mississippi,Union County,27777,27780,27953,3,173,75,329,91,356,-16,-27,-1,5,21,193,20,198,-1,2,171,171,171,11.80629071,12.77519602,-0.968905316,0.17942691,6.925878743,7.105305654
50,3,6,28,147,Mississippi,Walthall County,13884,13863,13836,-21,-27,26,161,47,205,-21,-44,0,0,2,15,2,15,-2,2,56,56,56,11.62496841,14.80197841,-3.17701,0,1.083071591,1.083071591
50,3,6,28,149,Mississippi,Warren County,44722,44548,43579,-174,-969,130,534,133,580,-3,-46,-1,17,-171,-928,-172,-911,1,-12,399,399,399,12.1188739,13.16282184,-1.043947939,0.385806847,-21.06051494,-20.67470809
50,3,6,28,151,Mississippi,Washington County,44922,44613,43687,-309,-926,143,575,184,712,-41,-137,0,11,-269,-792,-269,-781,1,-8,577,577,577,13.02378256,16.12684032,-3.103057758,0.249150623,-17.93884485,-17.68969422
50,3,6,28,153,Mississippi,Wayne County,19779,19778,19709,-1,-69,50,303,72,245,-22,58,0,0,21,-128,21,-128,0,1,68,68,68,15.34682301,12.40914731,2.937675691,0,-6.483146352,-6.483146352
50,3,6,28,155,Mississippi,Webster County,9926,9921,9983,-5,62,29,116,34,172,-5,-56,0,0,0,118,0,118,0,0,46,46,46,11.65594855,17.2829582,-5.627009646,0,11.85691318,11.85691318
50,3,6,28,157,Mississippi,Wilkinson County,8587,8525,8315,-62,-210,19,99,33,146,-14,-47,0,0,-48,-161,-48,-161,0,-2,1052,1052,1052,11.75771972,17.33966746,-5.581947743,0,-19.12114014,-19.12114014
50,3,6,28,159,Mississippi,Winston County,17714,17673,17596,-41,-77,37,184,53,269,-16,-85,0,-1,-24,7,-24,6,-1,2,395,395,395,10.43409226,15.25418923,-4.820096969,-0.056707023,0.396949162,0.340242139
50,3,6,28,161,Mississippi,Yalobusha County,12481,12446,12415,-35,-31,39,141,54,222,-15,-81,0,0,-18,49,-18,49,-2,1,142,142,142,11.34306746,17.8592977,-6.51623024,0,3.941917059,3.941917059
50,3,6,28,163,Mississippi,Yazoo County,26743,26618,26373,-125,-245,61,289,97,319,-36,-30,-2,-3,-87,-214,-89,-217,0,2,4314,4314,4314,10.9075126,12.03978034,-1.132267744,-0.113226774,-8.076843238,-8.190070012
40,2,4,29,0,Missouri,Missouri,6154913,6154481,6168187,-432,13706,17458,68818,18574,73333,-1116,-4515,129,2942,672,14861,801,17803,-117,418,158117,158117,158117,11.16933443,11.90213029,-0.732795852,0.477493997,2.411977666,2.889471663
50,2,4,29,1,Missouri,Adair County,25314,25246,25185,-68,-61,63,278,67,227,-4,51,3,46,-67,-161,-64,-115,0,3,2827,2827,2827,11.0249648,9.002399318,2.022565486,1.824274752,-6.384961631,-4.560686879
50,2,4,29,3,Missouri,Andrew County,18135,18083,18002,-52,-81,47,195,64,220,-17,-25,0,0,-34,-59,-34,-59,-1,3,175,175,175,10.80781488,12.19343217,-1.385617293,0,-3.27005681,-3.27005681
50,2,4,29,5,Missouri,Atchison County,5305,5306,5234,1,-72,9,48,14,86,-5,-38,0,1,7,-35,7,-34,-1,0,94,94,94,9.108159393,16.31878558,-7.210626186,0.189753321,-6.641366224,-6.451612903
50,2,4,29,7,Missouri,Audrain County,24962,24925,24982,-37,57,62,284,96,358,-34,-74,0,3,-1,124,-1,127,-2,4,1740,1740,1740,11.38116897,14.34668483,-2.965515859,0.120223616,4.969242792,5.089466408
50,2,4,29,9,Missouri,Barry County,34534,34539,34712,5,173,119,356,126,488,-7,-132,0,-4,15,311,15,307,-3,-2,194,194,194,10.28143998,14.0936593,-3.812219318,-0.115521798,8.981819757,8.86629796
50,2,4,29,11,Missouri,Barton County,11637,11613,11658,-24,45,31,140,37,152,-6,-12,0,1,-19,57,-19,58,1,-1,66,66,66,12.03214301,13.06346955,-1.031326544,0.085943879,4.898801083,4.984744962
50,2,4,29,13,Missouri,Bates County,16042,16044,16105,2,61,52,190,62,211,-10,-21,0,1,14,79,14,80,-2,2,244,244,244,11.8199633,13.12638029,-1.306416996,0.062210333,4.914616318,4.976826651
50,2,4,29,15,Missouri,Benton County,19394,19409,19908,15,499,37,158,95,370,-58,-212,0,-2,76,726,76,724,-3,-13,180,180,180,8.037235801,18.82137498,-10.78413918,-0.101737162,36.93058982,36.82885266
50,2,4,29,17,Missouri,Bollinger County,10567,10525,10556,-42,31,24,143,58,171,-34,-28,0,1,-8,57,-8,58,0,1,80,80,80,13.56671885,16.22313932,-2.656420473,0.09487216,5.407713107,5.502585266
50,2,4,29,19,Missouri,Boone County,183610,183894,185840,284,1946,491,1981,366,1420,125,561,6,261,146,1093,152,1354,7,31,8938,8938,8938,10.71581191,7.681197834,3.034614074,1.411825799,5.912358615,7.324184414
50,2,4,29,21,Missouri,Buchanan County,84793,84615,83853,-178,-762,269,1061,291,1085,-22,-24,1,46,-156,-786,-155,-740,-1,2,3766,3766,3766,12.5958639,12.88078448,-0.284920578,0.546097775,-9.331148942,-8.785051167
50,2,4,29,23,Missouri,Butler County,42130,42007,42101,-123,94,131,519,172,660,-41,-141,-1,1,-80,230,-81,231,-1,4,766,766,766,12.3412755,15.69410758,-3.352832073,0.023778951,5.469158701,5.492937652
50,2,4,29,25,Missouri,Caldwell County,8815,8806,8897,-9,91,24,96,37,110,-13,-14,0,0,4,107,4,107,0,-2,161,161,161,10.84561939,12.42727221,-1.581652827,0,12.08834661,12.08834661
50,2,4,29,27,Missouri,Callaway County,44283,44288,44638,5,350,125,463,136,482,-11,-19,0,4,17,362,17,366,-1,3,3438,3438,3438,10.41315251,10.8404741,-0.427321593,0.089962441,8.141600882,8.231563322
50,2,4,29,29,Missouri,Camden County,42745,42784,43436,39,652,100,361,154,710,-54,-349,0,2,100,1014,100,1016,-7,-15,575,575,575,8.373927163,16.46949664,-8.095569473,0.046392948,23.52122477,23.56761772
50,2,4,29,31,Missouri,Cape Girardeau County,81710,81788,82113,78,325,228,846,243,1003,-15,-157,2,66,93,403,95,469,-2,13,3827,3827,3827,10.32330492,12.23909555,-1.91579063,0.805364214,4.917602699,5.722966913
50,2,4,29,33,Missouri,Carroll County,8495,8461,8376,-34,-85,27,78,31,139,-4,-61,0,2,-29,-28,-29,-26,-1,2,58,58,58,9.265308547,16.51125497,-7.245946428,0.237572014,-3.326008196,-3.088436182
50,2,4,29,35,Missouri,Carter County,5202,5207,5320,5,113,17,79,18,108,-1,-29,0,0,7,144,7,144,-1,-2,14,14,14,15.00902441,20.51866629,-5.509641873,0,27.35822172,27.35822172
50,2,4,29,37,Missouri,Cass County,107824,108113,109638,289,1525,288,1090,250,1196,38,-106,-2,2,253,1640,251,1642,0,-11,955,955,955,10.01143508,10.98502418,-0.973589099,0.018369606,15.06307663,15.08144624
50,2,4,29,39,Missouri,Cedar County,14188,14199,14496,11,297,50,173,51,199,-1,-26,0,0,13,328,13,328,-1,-5,111,111,111,12.0578498,13.8700122,-1.812162398,0,22.86112563,22.86112563
50,2,4,29,41,Missouri,Chariton County,7408,7380,7356,-28,-24,19,83,23,137,-4,-54,0,1,-23,28,-23,29,-1,1,178,178,178,11.26492943,18.59391965,-7.328990228,0.135722041,3.800217155,3.935939197
50,2,4,29,43,Missouri,Christian County,88842,89224,91499,382,2275,236,1024,201,885,35,139,2,23,344,2137,346,2160,1,-24,459,459,459,11.33225987,9.793994124,1.538265744,0.254533181,23.64945248,23.90398566
50,2,4,29,45,Missouri,Clark County,6634,6632,6736,-2,104,22,83,28,78,-6,5,0,1,6,98,6,99,-2,0,61,61,61,12.41771394,11.66965889,0.748055057,0.149611011,14.66187911,14.81149013
50,2,4,29,47,Missouri,Clay County,253335,253923,255518,588,1595,762,2963,606,2209,156,754,4,106,421,686,425,792,7,49,2466,2466,2466,11.63235782,8.672250565,2.960107255,0.416142399,2.69314798,3.109290379
50,2,4,29,49,Missouri,Clinton County,21184,21204,21287,20,83,75,216,92,284,-17,-68,0,1,38,146,38,147,-1,4,396,396,396,10.16685886,13.36753666,-3.200677791,0.047068791,6.872043492,6.919112283
50,2,4,29,51,Missouri,Cole County,77279,77198,77205,-81,7,178,825,238,853,-60,-28,1,33,-20,-11,-19,22,-2,13,4185,4185,4185,10.68632086,11.04900812,-0.362687253,0.427452835,-0.142484278,0.284968556
50,2,4,29,53,Missouri,Cooper County,17103,17089,17115,-14,26,51,175,55,198,-4,-23,0,1,-10,45,-10,46,0,3,900,900,900,10.23272132,11.57759326,-1.344871945,0.058472693,2.631271196,2.68974389
50,2,4,29,55,Missouri,Crawford County,23056,23026,22807,-30,-219,56,231,78,357,-22,-126,0,-1,-7,-94,-7,-95,-1,2,227,227,227,10.08007331,15.57829512,-5.498221805,-0.043636681,-4.101848013,-4.145484694
50,2,4,29,57,Missouri,Dade County,7569,7586,7599,17,13,24,62,23,129,1,-67,0,1,17,79,17,80,-1,0,104,104,104,8.165953243,16.9904511,-8.82449786,0.131708923,10.40500494,10.53671386
50,2,4,29,59,Missouri,Dallas County,17071,17099,17341,28,242,53,203,78,283,-25,-80,0,8,54,317,54,325,-1,-3,143,143,143,11.78861789,16.43437863,-4.645760743,0.464576074,18.40882695,18.87340302
50,2,4,29,61,Missouri,Daviess County,8430,8427,8399,-3,-28,32,121,29,108,3,13,0,0,-5,-41,-5,-41,-1,0,138,138,138,14.38250327,12.83727565,1.545227624,0,-4.873410199,-4.873410199
50,2,4,29,63,Missouri,DeKalb County,11029,11014,11098,-15,84,28,87,35,154,-7,-67,0,1,-7,151,-7,152,-1,-1,1823,1823,1823,7.869030391,13.92908828,-6.060057887,0.090448625,13.6577424,13.74819103
50,2,4,29,65,Missouri,Dent County,14421,14418,14432,-3,14,48,137,49,274,-1,-137,0,0,-2,152,-2,152,0,-1,122,122,122,9.497400347,18.99480069,-9.497400347,0,10.5372617,10.5372617
50,2,4,29,67,Missouri,Douglas County,11578,11592,11732,14,140,36,118,52,196,-16,-78,0,0,32,219,32,219,-2,-1,57,57,57,10.11833305,16.80672269,-6.688389642,0,18.77894015,18.77894015
50,2,4,29,69,Missouri,Dunklin County,28283,28178,27717,-105,-461,91,359,139,530,-48,-171,0,12,-56,-304,-56,-292,-1,2,498,498,498,12.84551391,18.96412917,-6.118615261,0.42937651,-10.87753824,-10.44816173
50,2,4,29,71,Missouri,Franklin County,104682,104769,105231,87,462,279,1139,331,1322,-52,-183,-1,8,143,626,142,634,-3,11,761,761,761,10.84761905,12.59047619,-1.742857143,0.076190476,5.961904762,6.038095238
50,2,4,29,73,Missouri,Gasconade County,14794,14745,14791,-49,46,33,143,73,242,-40,-99,0,0,-8,146,-8,146,-1,-1,213,213,213,9.683098592,16.38678223,-6.70368364,0,9.88624052,9.88624052
50,2,4,29,75,Missouri,Gentry County,6162,6115,6173,-47,58,12,82,42,94,-30,-12,0,0,-18,72,-18,72,1,-2,101,101,101,13.34635417,15.29947917,-1.953125,0,11.71875,11.71875
50,2,4,29,77,Missouri,Greene County,298915,299060,300865,145,1805,780,3249,861,3385,-81,-136,-1,121,230,1778,229,1899,-3,42,11203,11203,11203,10.83135392,11.28474393,-0.453390007,0.403383756,5.927407593,6.330791349
50,2,4,29,79,Missouri,Grundy County,9808,9729,9720,-79,-9,22,105,52,138,-30,-33,0,4,-47,19,-47,23,-2,1,325,325,325,10.79747031,14.19096098,-3.393490668,0.411332202,1.95382796,2.365160163
50,2,4,29,81,Missouri,Harrison County,8157,8155,8164,-2,9,27,87,30,119,-3,-32,0,0,1,40,1,40,0,1,108,108,108,10.66241804,14.58422698,-3.921808934,0,4.902261168,4.902261168
50,2,4,29,83,Missouri,Henry County,21946,21949,22206,3,257,60,278,93,357,-33,-79,0,1,39,337,39,338,-3,-2,185,185,185,12.59200544,16.17030914,-3.578303703,0.045294984,15.26440947,15.30970445
50,2,4,29,85,Missouri,Hickory County,8279,8303,8607,24,304,25,89,36,163,-11,-74,0,0,35,385,35,385,0,-7,38,38,38,10.52631579,19.27853341,-8.752217623,0,45.53518628,45.53518628
50,2,4,29,87,Missouri,Holt County,4223,4186,4226,-37,40,11,37,15,82,-4,-45,0,0,-33,87,-33,87,0,-2,77,77,77,8.796956729,19.49595816,-10.69900143,0,20.68473609,20.68473609
50,2,4,29,89,Missouri,Howard County,10151,10144,10168,-7,24,22,109,29,95,-7,14,0,1,-1,7,-1,8,1,2,704,704,704,10.73257188,9.354076408,1.378495471,0.098463962,0.689247735,0.787711698
50,2,4,29,91,Missouri,Howell County,39750,39750,39975,0,225,110,470,167,607,-57,-137,0,2,60,358,60,360,-3,2,495,495,495,11.79052995,15.227344,-3.436814048,0.050172468,8.980871747,9.031044215
50,2,4,29,93,Missouri,Iron County,9537,9515,9408,-22,-107,19,98,44,201,-25,-103,0,0,5,-6,5,-6,-2,2,169,169,169,10.35776568,21.2439888,-10.88622311,0,-0.634148919,-0.634148919
50,2,4,29,95,Missouri,Jackson County,717204,717243,716862,39,-381,2135,8648,1867,7892,268,756,11,449,-241,-1732,-230,-1283,1,146,10714,10714,10714,12.06048372,11.00616761,1.054316107,0.626174513,-2.415443779,-1.789269266
50,2,4,29,97,Missouri,Jasper County,122761,122766,123155,5,389,372,1479,381,1484,-9,-5,-2,77,16,291,14,368,0,26,2400,2400,2400,12.02825298,12.06891644,-0.040663465,0.626217363,2.366613669,2.992831031
50,2,4,29,99,Missouri,Jefferson County,226739,226929,227771,190,842,610,2377,656,2615,-46,-238,1,29,235,1016,236,1045,0,35,1848,1848,1848,10.45524522,11.50208929,-1.046844073,0.127556631,4.468880581,4.596437211
50,2,4,29,101,Missouri,Johnson County,54013,54002,54150,-11,148,153,672,107,505,46,167,6,9,-65,-41,-59,-32,2,13,3586,3586,3586,12.42695466,9.338708484,3.088246172,0.166432428,-0.758192174,-0.591759746
50,2,4,29,103,Missouri,Knox County,3744,3732,3808,-12,76,7,57,9,44,-2,13,0,0,-9,63,-9,63,-1,0,42,42,42,15.1193634,11.67108753,3.448275862,0,16.71087533,16.71087533
50,2,4,29,105,Missouri,Laclede County,36039,36024,36133,-15,109,116,432,123,480,-7,-48,0,0,-7,151,-7,151,-1,6,286,286,286,11.97389027,13.30432252,-1.330432252,0,4.185318126,4.185318126
50,2,4,29,107,Missouri,Lafayette County,32984,33001,32817,17,-184,88,382,124,441,-36,-59,0,2,56,-132,56,-130,-3,5,647,647,647,11.60776687,13.4005895,-1.792822632,0.060773649,-4.011060804,-3.950287155
50,2,4,29,109,Missouri,Lawrence County,38001,37963,38321,-38,358,122,472,130,534,-8,-62,0,1,-30,420,-30,421,0,-1,454,454,454,12.37480992,14.00031461,-1.625504693,0.026217818,11.0114834,11.03770122
50,2,4,29,111,Missouri,Lewis County,10032,10031,10000,-1,-31,21,101,24,131,-3,-30,0,0,3,-3,3,-3,-1,2,774,774,774,10.08436923,13.07972642,-2.995357196,0,-0.29953572,-0.29953572
50,2,4,29,113,Missouri,Lincoln County,59574,59829,61586,255,1757,195,752,137,592,58,160,0,0,194,1614,194,1614,3,-17,537,537,537,12.38726681,9.751678129,2.635588683,0,26.58650084,26.58650084
50,2,4,29,115,Missouri,Linn County,11874,11849,11843,-25,-6,27,133,38,193,-11,-60,0,2,-13,51,-13,53,-1,1,121,121,121,11.22741854,16.29241938,-5.065000844,0.168833362,4.305250718,4.474084079
50,2,4,29,117,Missouri,Livingston County,14557,14562,14755,5,193,51,150,37,208,14,-58,0,3,-9,249,-9,252,0,-1,1196,1196,1196,10.23297063,14.18971928,-3.956748644,0.204659413,16.98673125,17.19139066
50,2,4,29,119,Missouri,McDonald County,23303,23285,23383,-18,98,77,295,59,300,18,-5,1,26,-36,73,-35,99,-1,4,133,133,133,12.64249593,12.85677552,-0.214279592,1.114253879,3.128482043,4.242735922
50,2,4,29,121,Missouri,Macon County,15209,15182,15183,-27,1,51,167,77,210,-26,-43,0,4,0,37,0,41,-1,3,248,248,248,10.99950601,13.83171415,-2.832208134,0.263461222,2.437016302,2.700477524
50,2,4,29,123,Missouri,Madison County,12626,12600,12652,-26,52,34,131,71,206,-37,-75,0,0,12,126,12,126,-1,1,159,159,159,10.37541581,16.31553936,-5.940123555,0,9.979407572,9.979407572
50,2,4,29,125,Missouri,Maries County,8432,8427,8406,-5,-21,25,95,45,133,-20,-38,0,3,16,12,16,15,-1,2,28,28,28,11.28735223,15.80229312,-4.51494089,0.356442702,1.425770807,1.782213509
50,2,4,29,127,Missouri,Marion County,28525,28470,28518,-55,48,77,325,93,362,-16,-37,0,7,-38,72,-38,79,-1,6,1287,1287,1287,11.40591002,12.704429,-1.298518986,0.245665754,2.526847757,2.772513512
50,2,4,29,129,Missouri,Mercer County,3538,3515,3488,-23,-27,13,38,18,40,-5,-2,0,2,-17,-27,-17,-25,-1,0,40,40,40,10.85249179,11.42367557,-0.571183778,0.571183778,-7.710981008,-7.13979723
50,2,4,29,131,Missouri,Miller County,24722,24733,24909,11,176,75,296,100,331,-25,-35,0,-1,38,209,38,208,-2,3,181,181,181,11.92538576,13.33548205,-1.410096289,-0.040288465,8.420289271,8.380000806
50,2,4,29,133,Missouri,Mississippi County,12577,12537,12538,-40,1,38,149,65,208,-27,-59,0,0,-14,58,-14,58,1,2,1314,1314,1314,11.88434696,16.59022931,-4.705882353,0,4.626121635,4.626121635
50,2,4,29,135,Missouri,Moniteau County,15473,15464,15484,-9,20,53,172,57,202,-4,-30,0,2,-5,44,-5,46,0,4,815,815,815,11.11541941,13.05415536,-1.938735944,0.129249063,2.843479385,2.972728448
50,2,4,29,137,Missouri,Monroe County,8666,8666,8712,0,46,19,101,35,116,-16,-15,0,0,18,60,18,60,-2,1,101,101,101,11.62389228,13.35021291,-1.726320635,0,6.905282541,6.905282541
50,2,4,29,139,Missouri,Montgomery County,11322,11262,11415,-60,153,31,125,56,180,-25,-55,0,1,-35,210,-35,211,0,-3,336,336,336,11.02438594,15.87511576,-4.850729814,0.088195088,18.52096838,18.60916347
50,2,4,29,141,Missouri,Morgan County,21006,20997,21379,-9,382,73,246,91,355,-18,-109,0,0,11,499,11,499,-2,-8,264,264,264,11.61034548,16.75476685,-5.144421371,0,23.55106664,23.55106664
50,2,4,29,143,Missouri,New Madrid County,16434,16329,16035,-105,-294,49,204,74,314,-25,-110,0,-1,-79,-183,-79,-184,-1,0,243,243,243,12.60659993,19.40427636,-6.797676431,-0.061797058,-11.3088617,-11.37065876
50,2,4,29,145,Missouri,Newton County,58648,58613,59386,-35,773,144,672,186,717,-42,-45,-1,16,11,805,10,821,-3,-3,800,800,800,11.38992703,12.15264536,-0.762718328,0.271188739,13.64418343,13.91537216
50,2,4,29,147,Missouri,Nodaway County,21241,21218,21160,-23,-58,60,205,38,210,22,-5,0,2,-45,-59,-45,-57,0,4,3261,3261,3261,9.67483128,9.910802775,-0.235971495,0.094388598,-2.784463637,-2.690075039
50,2,4,29,149,Missouri,Oregon County,8635,8617,8631,-18,14,31,93,33,164,-2,-71,0,0,-15,85,-15,85,-1,0,64,64,64,10.783859,19.01669759,-8.23283859,0,9.856215213,9.856215213
50,2,4,29,151,Missouri,Osage County,13274,13249,13379,-25,130,32,139,35,152,-3,-13,0,0,-22,144,-22,144,0,-1,332,332,332,10.4401382,11.416554,-0.976415803,0,10.81568274,10.81568274
50,2,4,29,153,Missouri,Ozark County,8553,8514,8782,-39,268,10,68,45,155,-35,-87,0,0,-3,363,-3,363,-1,-8,59,59,59,7.863089732,17.92321924,-10.06012951,0,41.97502313,41.97502313
50,2,4,29,155,Missouri,Pemiscot County,15661,15585,15236,-76,-349,60,226,74,286,-14,-60,0,0,-61,-287,-61,-287,-1,-2,159,159,159,14.66532559,18.55877486,-3.893449272,0,-18.62366568,-18.62366568
50,2,4,29,157,Missouri,Perry County,18956,18960,18922,4,-38,50,211,54,274,-4,-63,1,6,8,16,9,22,-1,3,214,214,214,11.13985534,14.46597329,-3.326117945,0.316773138,0.844728367,1.161501505
50,2,4,29,159,Missouri,Pettis County,42980,42951,43188,-29,237,148,583,147,518,1,65,0,21,-28,143,-28,164,-2,8,789,789,789,13.53626116,12.02707252,1.509188637,0.487584021,3.320215001,3.807799023
50,2,4,29,161,Missouri,Phelps County,44638,44517,44937,-121,420,103,396,156,560,-53,-164,2,65,-70,519,-68,584,0,0,2938,2938,2938,8.853712523,12.52040155,-3.666689025,1.453260894,11.60372929,13.05699019
50,2,4,29,163,Missouri,Pike County,17587,17613,17761,26,148,65,188,54,221,11,-33,0,1,15,181,15,182,0,-1,1456,1456,1456,10.62927574,12.49505286,-1.865777124,0.056538701,10.23350483,10.29004354
50,2,4,29,165,Missouri,Platte County,106718,107100,108569,382,1469,318,1156,232,882,86,274,-1,85,296,1104,295,1189,1,6,769,769,769,10.72013131,8.179200534,2.540930778,0.788244949,10.23791087,11.02615582
50,2,4,29,167,Missouri,Polk County,31519,31577,32043,58,466,97,404,105,440,-8,-36,0,2,66,504,66,506,0,-4,1355,1355,1355,12.70040868,13.83212826,-1.131719585,0.06287331,15.84407419,15.9069475
50,2,4,29,169,Missouri,Pulaski County,53955,53964,53816,9,-148,186,691,118,362,68,329,25,-11,-88,-473,-63,-484,4,7,10119,10119,10119,12.82241603,6.71738727,6.105028762,-0.204119503,-8.777138616,-8.981258118
50,2,4,29,171,Missouri,Putnam County,4681,4676,4712,-5,36,11,62,20,51,-9,11,0,0,5,24,5,24,-1,1,46,46,46,13.20835109,10.86493396,2.343417128,0,5.112910098,5.112910098
50,2,4,29,173,Missouri,Ralls County,10355,10351,10361,-4,10,29,85,35,139,-6,-54,0,0,3,63,3,63,-1,1,40,40,40,8.20780224,13.42217072,-5.214368482,0,6.083429896,6.083429896
50,2,4,29,175,Missouri,Randolph County,24716,24636,24760,-80,124,63,248,76,305,-13,-57,0,3,-67,175,-67,178,0,3,2222,2222,2222,10.04129889,12.34917807,-2.307879181,0.121467325,7.085593975,7.207061301
50,2,4,29,177,Missouri,Ray County,23158,23100,23008,-58,-92,66,242,103,343,-37,-101,0,2,-20,4,-20,6,-1,3,267,267,267,10.49709378,14.87811226,-4.381018478,0.086752841,0.173505682,0.260258524
50,2,4,29,179,Missouri,Reynolds County,6096,6078,6087,-18,9,20,66,23,96,-3,-30,0,0,-15,39,-15,39,0,0,75,75,75,10.85080148,15.78298397,-4.932182491,0,6.411837238,6.411837238
50,2,4,29,181,Missouri,Ripley County,10679,10680,10617,1,-63,46,149,51,233,-5,-84,0,0,6,19,6,19,0,2,31,31,31,13.99258112,21.88101611,-7.888434991,0,1.784288867,1.784288867
50,2,4,29,183,Missouri,St. Charles County,405262,406258,409981,996,3723,1112,4068,938,3836,174,232,3,192,819,3263,822,3455,0,36,5144,5144,5144,9.967668783,9.39920783,0.568460953,0.470450444,7.995207286,8.46565773
50,2,4,29,185,Missouri,St. Clair County,9284,9340,9376,56,36,21,102,40,172,-19,-70,0,0,77,106,77,106,-2,0,149,149,149,10.89976491,18.37999573,-7.480230819,0,11.32720667,11.32720667
50,2,4,29,186,Missouri,Ste. Genevieve County,18479,18476,18588,-3,112,56,204,46,212,10,-8,0,2,-11,117,-11,119,-2,1,257,257,257,11.00798619,11.43967192,-0.431685733,0.107921433,6.313403842,6.421325275
50,2,4,29,187,Missouri,St. Francois County,66922,66900,67541,-22,641,166,676,235,961,-69,-285,-1,6,49,921,48,927,-1,-1,6234,6234,6234,10.05645599,14.29623404,-4.239778044,0.089258485,13.70117747,13.79043595
50,2,4,29,189,Missouri,St. Louis County,1004125,1002838,997187,-1287,-5651,2669,10641,3135,12243,-466,-1602,58,723,-848,-4915,-790,-4192,-31,143,18592,18592,18592,10.64086699,12.24284696,-1.601979975,0.722990963,-4.914938563,-4.191947601
50,2,4,29,195,Missouri,Saline County,23333,23319,23289,-14,-30,70,256,79,296,-9,-40,1,26,-4,-21,-3,5,-2,5,1464,1464,1464,10.98523859,12.70168212,-1.716443529,1.115688294,-0.901132853,0.214555441
50,2,4,29,197,Missouri,Schuyler County,4032,4007,4025,-25,18,18,66,17,53,1,13,0,0,-25,4,-25,4,-1,1,27,27,27,16.43426295,13.19721116,3.237051793,0,0.996015936,0.996015936
50,2,4,29,199,Missouri,Scotland County,4716,4698,4693,-18,-5,17,81,13,47,4,34,0,0,-21,-39,-21,-39,-1,0,49,49,49,17.25055905,10.00958364,7.240975402,0,-8.305824726,-8.305824726
50,2,4,29,201,Missouri,Scott County,38059,38009,37840,-50,-169,130,466,146,558,-16,-92,0,-1,-31,-83,-31,-84,-3,7,459,459,459,12.28757136,14.71344382,-2.425872457,-0.026368179,-2.188558847,-2.214927026
50,2,4,29,203,Missouri,Shannon County,7031,7041,7106,10,65,26,72,25,120,1,-48,0,0,10,114,10,114,-1,-1,35,35,35,10.1788365,16.9647275,-6.785891002,0,16.11649113,16.11649113
50,2,4,29,205,Missouri,Shelby County,6103,6101,5976,-2,-125,18,65,15,90,3,-25,0,0,-4,-99,-4,-99,-1,-1,190,190,190,10.76426265,14.90436367,-4.140101018,0,-16.39480003,-16.39480003
50,2,4,29,207,Missouri,Stoddard County,28672,28652,28479,-20,-173,97,327,112,442,-15,-115,0,0,-4,-62,-4,-62,-1,4,585,585,585,11.44737533,15.47321069,-4.025835361,0,-2.170450368,-2.170450368
50,2,4,29,209,Missouri,Stone County,31076,31175,31548,99,373,70,262,123,473,-53,-211,0,-1,157,595,157,594,-5,-10,197,197,197,8.354192242,15.08218676,-6.727994516,-0.03188623,18.97230681,18.94042058
50,2,4,29,211,Missouri,Sullivan County,5999,5976,5934,-23,-42,20,82,28,67,-8,15,0,4,-16,-60,-16,-56,1,-1,82,82,82,13.76994123,11.25104954,2.518891688,0.67170445,-10.07556675,-9.403862301
50,2,4,29,213,Missouri,Taney County,56066,56020,56387,-46,367,163,589,207,679,-44,-90,-1,22,3,431,2,453,-4,4,1667,1667,1667,10.47977439,12.08109815,-1.601323761,0.391434697,7.668561567,8.059996264
50,2,4,29,215,Missouri,Texas County,24487,24413,24987,-74,574,58,254,109,355,-51,-101,0,0,-21,686,-21,686,-2,-11,1556,1556,1556,10.28340081,14.37246964,-4.089068826,0,27.77327935,27.77327935
50,2,4,29,217,Missouri,Vernon County,19707,19642,19595,-65,-47,59,251,58,274,1,-23,0,0,-66,-25,-66,-25,0,1,722,722,722,12.79404644,13.96640926,-1.172362821,0,-1.274307414,-1.274307414
50,2,4,29,219,Missouri,Warren County,35532,35707,36518,175,811,76,407,89,412,-13,-5,1,6,187,818,188,824,0,-8,220,220,220,11.27033576,11.40879197,-0.138456213,0.166147456,22.65143648,22.81758394
50,2,4,29,221,Missouri,Washington County,23514,23499,23502,-15,3,71,248,80,353,-9,-105,0,0,-5,106,-5,106,-1,2,908,908,908,10.55296696,15.020957,-4.467990043,0,4.510542329,4.510542329
50,2,4,29,223,Missouri,Wayne County,10974,10913,10914,-61,1,27,113,71,205,-44,-92,0,0,-15,93,-15,93,-2,0,68,68,68,10.35414853,18.78407477,-8.429926238,0,8.521555871,8.521555871
50,2,4,29,225,Missouri,Webster County,39085,39168,39735,83,567,142,562,108,452,34,110,0,5,48,454,48,459,1,-2,650,650,650,14.24533921,11.45710556,2.788233654,0.126737893,11.50780072,11.63453861
50,2,4,29,227,Missouri,Worth County,1973,1962,1983,-11,21,4,28,6,23,-2,5,0,0,-8,16,-8,16,-1,0,47,47,47,14.19518378,11.66032953,2.534854246,0,8.111533587,8.111533587
50,2,4,29,229,Missouri,Wright County,18188,18180,18610,-8,430,56,220,62,233,-6,-13,-1,-1,0,449,-1,448,-1,-5,144,144,144,11.95977168,12.66648546,-0.706713781,-0.054362599,24.40880674,24.35444414
50,2,4,29,510,Missouri,St. Louis city,301578,300528,293310,-1050,-7218,956,3783,906,3718,50,65,12,397,-1115,-7577,-1103,-7180,3,-103,11576,11576,11576,12.74084851,12.52193359,0.218914923,1.337064991,-25.51874417,-24.18167918
40,4,8,30,0,Montana,Montana,1084225,1086193,1104271,1968,18078,2783,10502,3050,12022,-267,-1520,28,551,2243,19240,2271,19791,-36,-193,27250,27250,27250,9.588835973,10.97666978,-1.387833811,0.503089756,17.56705429,18.07014404
50,4,8,30,1,Montana,Beaverhead County,9371,9372,9524,1,152,14,63,17,107,-3,-44,0,2,6,195,6,197,-2,-1,404,404,404,6.6680779,11.32514818,-4.657070279,0.211685013,20.63928874,20.85097375
50,4,8,30,3,Montana,Big Horn County,13124,13051,12957,-73,-94,44,225,53,183,-9,42,0,3,-65,-139,-65,-136,1,0,104,104,104,17.3023685,14.07259305,3.229775454,0.230698247,-10.68901876,-10.45832052
50,4,8,30,5,Montana,Blaine County,7044,7002,6980,-42,-22,27,84,25,83,2,1,0,2,-45,-25,-45,-23,1,0,218,218,218,12.01544843,11.87240738,0.143041053,0.286082106,-3.57602632,-3.289944214
50,4,8,30,7,Montana,Broadwater County,6774,6846,7288,72,442,16,54,9,65,7,-11,0,1,66,460,66,461,-1,-8,50,50,50,7.641149002,9.197679355,-1.556530352,0.141502759,65.09126928,65.23277204
50,4,8,30,9,Montana,Carbon County,10473,10512,10847,39,335,12,46,27,110,-15,-64,0,4,55,401,55,405,-1,-6,24,24,24,4.307317758,10.30010768,-5.992789925,0.37454937,37.54857437,37.92312374
50,4,8,30,11,Montana,Carter County,1415,1413,1428,-2,15,6,14,4,13,2,1,0,0,-4,14,-4,14,0,0,11,11,11,9.855684618,9.151707145,0.703977473,0,9.855684618,9.855684618
50,4,8,30,13,Montana,Cascade County,84414,84328,84511,-86,183,255,961,271,1024,-16,-63,5,25,-72,208,-67,233,-3,13,2432,2432,2432,11.38362582,12.1298989,-0.746273077,0.29614011,2.463885714,2.760025823
50,4,8,30,15,Montana,Chouteau County,5895,5899,5916,4,17,13,33,18,62,-5,-29,0,2,9,44,9,46,0,0,132,132,132,5.58611934,10.49513331,-4.909013965,0.338552687,7.44815912,7.786711807
50,4,8,30,17,Montana,Custer County,11867,11859,11916,-8,57,29,100,29,173,0,-73,0,-1,-7,131,-7,130,-1,0,428,428,428,8.412197687,14.553102,-6.140904311,-0.084121977,11.01997897,10.93585699
50,4,8,30,19,Montana,Daniels County,1661,1658,1686,-3,28,5,9,6,14,-1,-5,0,0,-1,33,-1,33,-1,0,37,37,37,5.38277512,8.373205742,-2.990430622,0,19.73684211,19.73684211
50,4,8,30,21,Montana,Dawson County,8940,8922,8904,-18,-18,26,98,21,99,5,-1,0,1,-21,-20,-21,-19,-2,2,494,494,494,10.99517559,11.10737126,-0.112195669,0.112195669,-2.243913385,-2.131717716
50,4,8,30,23,Montana,Deer Lodge County,9421,9413,9491,-8,78,16,68,37,135,-21,-67,0,0,14,147,14,147,-1,-2,845,845,845,7.194244604,14.28269149,-7.08844689,0,15.55226407,15.55226407
50,4,8,30,25,Montana,Fallon County,3049,3033,3017,-16,-16,10,39,12,26,-2,13,0,3,-15,-32,-15,-29,1,0,32,32,32,12.89256198,8.595041322,4.297520661,0.991735537,-10.5785124,-9.58677686
50,4,8,30,27,Montana,Fergus County,11446,11457,11617,11,160,28,106,41,152,-13,-46,0,7,25,202,25,209,-1,-3,451,451,451,9.187830459,13.17500217,-3.987171708,0.606743521,17.50888446,18.11562798
50,4,8,30,29,Montana,Flathead County,104357,104773,108454,416,3681,251,1026,287,1168,-36,-142,-2,26,458,3855,456,3881,-4,-58,862,862,862,9.623546737,10.95546061,-1.331913876,0.243871555,36.15864783,36.40251938
50,4,8,30,31,Montana,Gallatin County,118960,119502,122713,542,3211,295,1086,197,732,98,354,10,104,427,2777,437,2881,7,-24,3293,3293,3293,8.967239849,6.044216915,2.923022934,0.858741201,22.93004149,23.78878269
50,4,8,30,33,Montana,Garfield County,1173,1172,1209,-1,37,2,12,2,13,0,-1,0,0,-1,40,-1,40,0,-2,0,0,0,10.0797984,10.9197816,-0.8399832,0,33.59932801,33.59932801
50,4,8,30,35,Montana,Glacier County,13778,13747,13785,-31,38,50,178,40,141,10,37,0,3,-42,-5,-42,-2,1,3,656,656,656,12.93040825,10.24262676,2.687781491,0.217928229,-0.363213715,-0.145285486
50,4,8,30,37,Montana,Golden Valley County,823,820,831,-3,11,3,13,5,6,-2,7,0,0,-1,3,-1,3,0,1,89,89,89,15.7480315,7.268322229,8.479709267,0,3.634161115,3.634161115
50,4,8,30,39,Montana,Granite County,3309,3308,3344,-1,36,7,19,8,32,-1,-13,0,0,1,50,1,50,-1,-1,27,27,27,5.712567649,9.621166566,-3.908598918,0,15.03307276,15.03307276
50,4,8,30,41,Montana,Hill County,16309,16250,16179,-59,-71,55,239,50,189,5,50,0,7,-65,-128,-65,-121,1,0,506,506,506,14.73989331,11.65623362,3.083659687,0.431712356,-7.8941688,-7.462456443
50,4,8,30,43,Montana,Jefferson County,12085,12133,12470,48,337,25,82,32,132,-7,-50,0,-1,56,394,56,393,-1,-6,159,159,159,6.665853758,10.73039873,-4.064544974,-0.081290899,32.0286144,31.9473235
50,4,8,30,45,Montana,Judith Basin County,2023,2017,2044,-6,27,4,24,6,16,-2,8,0,0,-4,19,-4,19,0,0,0,0,0,11.81974883,7.879832554,3.939916277,0,9.357301157,9.357301157
50,4,8,30,47,Montana,Lake County,31134,31259,32033,125,774,77,317,64,402,13,-85,0,6,115,862,115,868,-3,-9,540,540,540,10.01706377,12.70302724,-2.685963471,0.189597422,27.23882955,27.42842697
50,4,8,30,49,Montana,Lewis and Clark County,70973,71093,72223,120,1130,177,635,205,805,-28,-170,1,28,150,1282,151,1310,-3,-10,1895,1895,1895,8.861536744,11.23391666,-2.372379916,0.390744927,17.8905356,18.28128053
50,4,8,30,51,Montana,Liberty County,1959,1960,1946,1,-14,6,28,1,14,5,14,0,0,-4,-28,-4,-28,0,0,251,251,251,14.33691756,7.168458781,7.168458781,0,-14.33691756,-14.33691756
50,4,8,30,53,Montana,Lincoln County,19677,19731,20525,54,794,41,145,70,325,-29,-180,0,19,87,972,87,991,-4,-17,142,142,142,7.203895072,16.14666137,-8.942766296,0.943958665,48.290938,49.23489666
50,4,8,30,55,Montana,McCone County,1729,1733,1718,4,-15,6,23,3,17,3,6,0,0,1,-21,1,-21,0,0,17,17,17,13.32946972,9.852216749,3.47725297,0,-12.1703854,-12.1703854
50,4,8,30,57,Montana,Madison County,8623,8657,8917,34,260,16,53,29,116,-13,-63,0,23,48,306,48,329,-1,-6,115,115,115,6.031637647,13.20132013,-7.169682485,2.61750313,34.82417207,37.4416752
50,4,8,30,59,Montana,Meagher County,1927,1925,1964,-2,39,5,12,4,13,1,-1,0,1,-3,39,-3,40,0,0,172,172,172,6.17125225,6.685523271,-0.514271021,0.514271021,20.05656981,20.57084083
50,4,8,30,61,Montana,Mineral County,4535,4565,4860,30,295,7,32,13,57,-6,-25,0,1,37,325,37,326,-1,-6,18,18,18,6.790450928,12.09549072,-5.305039788,0.212201592,68.96551724,69.17771883
50,4,8,30,63,Montana,Missoula County,117922,118238,119533,316,1295,295,1032,290,1070,5,-38,9,105,302,1220,311,1325,0,8,3362,3362,3362,8.68062127,9.000256549,-0.319635279,0.883202746,10.26197476,11.1451775
50,4,8,30,65,Montana,Musselshell County,4730,4747,4896,17,149,9,31,9,74,0,-43,0,1,18,194,18,195,-1,-3,49,49,49,6.429534377,15.34792077,-8.918386394,0.207404335,40.23644094,40.44384528
50,4,8,30,67,Montana,Park County,17191,17193,17473,2,280,27,123,67,194,-40,-71,0,1,43,353,43,354,-1,-3,98,98,98,7.096290313,11.19252293,-4.09623262,0.057693417,20.36577627,20.42346968
50,4,8,30,69,Montana,Petroleum County,496,498,519,2,21,1,3,0,3,1,0,0,0,2,21,2,21,-1,0,0,0,0,5.899705015,5.899705015,0,0,41.2979351,41.2979351
50,4,8,30,71,Montana,Phillips County,4217,4190,4192,-27,2,7,44,24,54,-17,-10,0,0,-10,13,-10,13,0,-1,125,125,125,10.49868766,12.88475304,-2.386065378,0,3.101884992,3.101884992
50,4,8,30,73,Montana,Pondera County,5898,5882,5994,-16,112,16,65,12,78,4,-13,0,2,-20,123,-20,125,0,0,633,633,633,10.94644662,13.13573594,-2.189289323,0.336813742,20.71404513,21.05085888
50,4,8,30,75,Montana,Powder River County,1694,1693,1702,-1,9,4,14,3,23,1,-9,0,0,-2,18,-2,18,0,0,33,33,33,8.24742268,13.54933726,-5.30191458,0,10.60382916,10.60382916
50,4,8,30,77,Montana,Powell County,6946,6934,6999,-12,65,9,45,21,94,-12,-49,0,1,1,114,1,115,-1,-1,1702,1702,1702,6.459484677,13.49314577,-7.033661092,0.143544104,16.36402785,16.50757195
50,4,8,30,79,Montana,Prairie County,1088,1076,1091,-12,15,1,7,11,10,-10,-3,0,0,-2,18,-2,18,0,0,19,19,19,6.460544532,9.229349331,-2.768804799,0,16.6128288,16.6128288
50,4,8,30,81,Montana,Ravalli County,44174,44351,45959,177,1608,89,361,147,608,-58,-247,0,11,240,1876,240,1887,-5,-32,393,393,393,7.994684974,13.46473259,-5.470047614,0.243605359,41.54578674,41.78939209
50,4,8,30,83,Montana,Richland County,11491,11501,11283,10,-218,25,140,25,106,0,34,0,-1,10,-247,10,-248,0,-4,34,34,34,12.28932584,9.304775281,2.984550562,-0.087780899,-21.68188202,-21.76966292
50,4,8,30,85,Montana,Roosevelt County,10794,10780,10821,-14,41,56,180,46,172,10,8,0,6,-24,25,-24,31,0,2,140,140,140,16.6658951,15.92518865,0.740706449,0.555529837,2.314707652,2.870237489
50,4,8,30,87,Montana,Rosebud County,8329,8298,8124,-31,-174,35,132,33,100,2,32,0,4,-32,-208,-32,-204,-1,-2,26,26,26,16.07599562,12.17878456,3.897211058,0.487151382,-25.33187188,-24.8447205
50,4,8,30,89,Montana,Sanders County,12400,12451,12959,51,508,28,77,42,169,-14,-92,0,1,66,608,66,609,-1,-9,178,178,178,6.060606061,13.30184967,-7.241243605,0.07870917,47.85517513,47.9338843
50,4,8,30,91,Montana,Sheridan County,3539,3518,3527,-21,9,7,29,16,57,-9,-28,0,0,-12,38,-12,38,0,-1,83,83,83,8.232789212,16.18168914,-7.948899929,0,10.78779276,10.78779276
50,4,8,30,93,Montana,Silver Bow County,35133,35168,35411,35,243,80,302,121,509,-41,-207,1,47,76,405,77,452,-1,-2,930,930,930,8.55778631,14.42355375,-5.865767438,1.331840916,11.47650151,12.80834243
50,4,8,30,95,Montana,Stillwater County,8963,9010,9044,47,34,18,68,19,96,-1,-28,0,0,48,62,48,62,0,0,42,42,42,7.532956686,10.63476238,-3.101805694,0,6.868284037,6.868284037
50,4,8,30,97,Montana,Sweet Grass County,3678,3671,3723,-7,52,9,28,10,41,-1,-13,0,1,-4,63,-4,64,-2,1,34,34,34,7.573708412,11.09007303,-3.51636462,0.270489586,17.04084393,17.31133351
50,4,8,30,99,Montana,Teton County,6226,6242,6269,16,27,14,78,19,86,-5,-8,0,4,22,32,22,36,-1,-1,438,438,438,12.46902726,13.74790185,-1.27887459,0.639437295,5.115498361,5.754935657
50,4,8,30,101,Montana,Toole County,4971,4964,5011,-7,47,23,59,23,46,0,13,0,0,-8,34,-8,34,1,0,674,674,674,11.82957394,9.223057644,2.606516291,0,6.817042607,6.817042607
50,4,8,30,103,Montana,Treasure County,762,761,768,-1,7,4,8,0,9,4,-1,0,0,-5,9,-5,9,0,-1,0,0,0,10.46435579,11.77240026,-1.308044474,0,11.77240026,11.77240026
50,4,8,30,105,Montana,Valley County,7578,7551,7537,-27,-14,22,55,33,93,-11,-38,0,1,-16,22,-16,23,0,1,120,120,120,7.290562036,12.32767763,-5.037115589,0.132555673,2.916224814,3.048780488
50,4,8,30,107,Montana,Wheatland County,2069,2093,2059,24,-34,13,18,4,26,9,-8,0,0,15,-25,15,-25,0,-1,118,118,118,8.670520231,12.52408478,-3.853564547,0,-12.04238921,-12.04238921
50,4,8,30,109,Montana,Wibaux County,937,928,934,-9,6,3,8,9,14,-6,-6,0,0,-3,12,-3,12,0,0,22,22,22,8.592910849,15.03759399,-6.444683136,0,12.88936627,12.88936627
50,4,8,30,111,Montana,Yellowstone County,164731,165045,167146,314,2101,460,1771,480,1866,-20,-95,4,101,333,2099,337,2200,-3,-4,3593,3593,3593,10.66254053,11.23450063,-0.571960107,0.608083904,12.63730806,13.24539196
40,2,4,31,0,Nebraska,Nebraska,1961504,1961455,1963692,-49,2237,6099,23524,5041,19213,1058,4311,25,1044,-1134,-3313,-1109,-2269,2,195,48139,48139,48139,11.98630268,9.789697048,2.19660563,0.531954599,-1.688089644,-1.156135044
50,2,4,31,1,Nebraska,Adams County,31205,31147,31027,-58,-120,92,357,118,371,-26,-14,2,46,-34,-156,-32,-110,0,4,1188,1188,1188,11.48390002,11.93424904,-0.45034902,1.47971821,-5.0181748,-3.53845659
50,2,4,31,3,Nebraska,Antelope County,6295,6276,6279,-19,3,24,75,23,82,1,-7,0,0,-20,10,-20,10,0,0,37,37,37,11.9474313,13.06252489,-1.115093588,0,1.59299084,1.59299084
50,2,4,31,5,Nebraska,Arthur County,434,431,439,-3,8,0,4,2,2,-2,2,0,0,-1,6,-1,6,0,0,0,0,0,9.195402299,4.597701149,4.597701149,0,13.79310345,13.79310345
50,2,4,31,7,Nebraska,Banner County,674,683,692,9,9,5,7,0,5,5,2,0,0,4,7,4,7,0,0,0,0,0,10.18181818,7.272727273,2.909090909,0,10.18181818,10.18181818
50,2,4,31,9,Nebraska,Blaine County,431,431,461,0,30,1,4,2,8,-1,-4,0,0,2,36,2,36,-1,-2,0,0,0,8.968609866,17.93721973,-8.968609865,0,80.71748879,80.71748879
50,2,4,31,11,Nebraska,Boone County,5379,5351,5386,-28,35,19,59,23,77,-4,-18,0,0,-23,54,-23,54,-1,-1,94,94,94,10.99003446,14.34292633,-3.352891869,0,10.05867561,10.05867561
50,2,4,31,13,Nebraska,Box Butte County,10842,10824,10604,-18,-220,33,107,26,152,7,-45,0,6,-24,-180,-24,-174,-1,-1,104,104,104,9.986932985,14.18704499,-4.200112003,0.560014934,-16.80044801,-16.24043308
50,2,4,31,15,Nebraska,Boyd County,1810,1806,1789,-4,-17,8,11,9,31,-1,-20,0,0,-4,4,-4,4,1,-1,19,19,19,6.11961057,17.24617524,-11.12656467,0,2.225312935,2.225312935
50,2,4,31,17,Nebraska,Brown County,2903,2903,2908,0,5,9,29,14,48,-5,-19,0,1,5,23,5,24,0,0,13,13,13,9.981070384,16.52039236,-6.539321976,0.344174841,7.916021339,8.26019618
50,2,4,31,19,Nebraska,Buffalo County,50084,50129,50339,45,210,147,587,112,510,35,77,0,18,10,102,10,120,0,13,2058,2058,2058,11.68531274,10.15248636,1.532826373,0.358323048,2.030497273,2.388820321
50,2,4,31,21,Nebraska,Burt County,6722,6721,6709,-1,-12,19,67,24,101,-5,-34,0,0,5,23,5,23,-1,-1,119,119,119,9.977661951,15.04095309,-5.063291139,0,3.425167535,3.425167535
50,2,4,31,23,Nebraska,Butler County,8369,8349,8444,-20,95,19,106,31,95,-12,11,0,0,-8,86,-8,86,0,-2,161,161,161,12.62430775,11.31423808,1.310069672,0,10.24236289,10.24236289
50,2,4,31,25,Nebraska,Cass County,26598,26593,27017,-5,424,66,235,77,311,-11,-76,0,4,8,499,8,503,-2,-3,218,218,218,8.767021078,11.602313,-2.835291923,0.149225891,18.61592986,18.76515576
50,2,4,31,27,Nebraska,Cedar County,8380,8373,8330,-7,-43,24,105,25,112,-1,-7,0,2,-4,-40,-4,-38,-2,2,106,106,106,12.57259175,13.41076453,-0.838172783,0.239477938,-4.789558762,-4.550080824
50,2,4,31,29,Nebraska,Chase County,3893,3881,3826,-12,-55,18,48,13,55,5,-7,0,1,-18,-49,-18,-48,1,0,60,60,60,12.45620864,14.27273907,-1.816530427,0.259504347,-12.71571299,-12.45620864
50,2,4,31,31,Nebraska,Cherry County,5455,5462,5458,7,-4,20,74,13,79,7,-5,0,2,1,-2,1,0,-1,1,18,18,18,13.55311355,14.46886447,-0.915750916,0.366300366,-0.366300366,0
50,2,4,31,33,Nebraska,Cheyenne County,9468,9482,9529,14,47,19,99,29,103,-10,-4,0,1,25,49,25,50,-1,1,66,66,66,10.41502288,10.83583189,-0.420809005,0.105202251,5.154910315,5.260112566
50,2,4,31,35,Nebraska,Clay County,6104,6101,6078,-3,-23,16,69,17,83,-1,-14,1,0,-2,-9,-1,-9,-1,0,42,42,42,11.33097956,13.63001889,-2.29903933,0,-1.477953855,-1.477953855
50,2,4,31,37,Nebraska,Colfax County,10582,10546,10498,-36,-48,47,191,19,60,28,131,1,55,-65,-232,-64,-177,0,-2,36,36,36,18.1524425,5.702337959,12.45010454,5.227143129,-22.04904011,-16.82189698
50,2,4,31,39,Nebraska,Cuming County,9013,9009,8984,-4,-25,34,113,35,105,-1,8,0,1,-2,-35,-2,-34,-1,1,75,75,75,12.56044017,11.67120547,0.889234702,0.111154338,-3.890401823,-3.779247485
50,2,4,31,41,Nebraska,Custer County,10545,10495,10460,-50,-35,27,103,35,150,-8,-47,0,0,-41,9,-41,9,-1,3,82,82,82,9.830589358,14.31639227,-4.485802911,0,0.858983536,0.858983536
50,2,4,31,43,Nebraska,Dakota County,21582,21502,21241,-80,-261,70,349,82,179,-12,170,-1,19,-69,-445,-70,-426,2,-5,250,250,250,16.33015932,8.375640456,7.954518869,0.889034462,-20.82212292,-19.93308846
50,2,4,31,45,Nebraska,Dawes County,8199,8151,8148,-48,-3,19,81,24,103,-5,-22,0,-2,-45,21,-45,19,2,0,919,919,919,9.939260077,12.6388122,-2.69955212,-0.245413829,2.576845205,2.331431376
50,2,4,31,47,Nebraska,Dawson County,24111,24039,23898,-72,-141,76,384,67,257,9,127,2,54,-83,-321,-81,-267,0,-1,275,275,275,16.0210276,10.72240649,5.298621107,2.252957006,-13.39257776,-11.13962075
50,2,4,31,49,Nebraska,Deuel County,1838,1829,1865,-9,36,1,17,2,14,-1,3,0,0,-7,33,-7,33,-1,0,0,0,0,9.204114781,7.579859231,1.62425555,0,17.86681105,17.86681105
50,2,4,31,51,Nebraska,Dixon County,5606,5580,5545,-26,-35,9,58,18,73,-9,-15,0,1,-15,-22,-15,-21,-2,1,58,58,58,10.42696629,13.12359551,-2.696629213,0.179775281,-3.95505618,-3.775280899
50,2,4,31,53,Nebraska,Dodge County,37167,37102,37103,-65,1,116,412,121,507,-5,-95,0,19,-59,73,-59,92,-1,4,1036,1036,1036,11.10437302,13.66484738,-2.560474362,0.512094872,1.967522404,2.479617277
50,2,4,31,55,Nebraska,Douglas County,584526,585010,585008,484,-2,1905,7721,1265,4980,640,2741,14,403,-187,-3226,-173,-2823,17,80,11995,11995,11995,13.19808755,8.512689548,4.685398002,0.688878291,-5.514445077,-4.825566786
50,2,4,31,57,Nebraska,Dundy County,1654,1647,1635,-7,-12,2,15,7,20,-5,-5,0,0,-2,-7,-2,-7,0,0,22,22,22,9.140767825,12.18769043,-3.046922608,0,-4.265691651,-4.265691651
50,2,4,31,59,Nebraska,Fillmore County,5551,5567,5546,16,-21,22,62,19,73,3,-11,0,0,13,-11,13,-11,0,1,177,177,177,11.15810312,13.13776658,-1.979663457,0,-1.979663457,-1.979663457
50,2,4,31,61,Nebraska,Franklin County,2889,2885,2903,-4,18,7,35,8,34,-1,1,0,0,-2,16,-2,16,-1,1,13,13,13,12.09398756,11.74844506,0.345542502,0,5.528680028,5.528680028
50,2,4,31,63,Nebraska,Frontier County,2519,2510,2555,-9,45,9,23,5,27,4,-4,0,0,-13,50,-13,50,0,-1,103,103,103,9.081934847,10.66140178,-1.57946693,0,19.74333662,19.74333662
50,2,4,31,65,Nebraska,Furnas County,4636,4615,4604,-21,-11,12,57,21,62,-9,-5,0,0,-11,-6,-11,-6,-1,0,38,38,38,12.36576635,13.4504827,-1.084716347,0,-1.301659616,-1.301659616
50,2,4,31,67,Nebraska,Gage County,21704,21663,21616,-41,-47,55,197,70,279,-15,-82,0,3,-25,29,-25,32,-1,3,487,487,487,9.10372236,12.89308903,-3.789366667,0.138635366,1.34014187,1.478777236
50,2,4,31,69,Nebraska,Garden County,1874,1883,1847,9,-36,10,14,13,20,-3,-6,0,0,11,-28,11,-28,1,-2,19,19,19,7.506702413,10.72386059,-3.217158177,0,-15.01340483,-15.01340483
50,2,4,31,71,Nebraska,Garfield County,1813,1806,1839,-7,33,6,30,8,26,-2,4,0,0,-5,29,-5,29,0,0,42,42,42,16.46090535,14.26611797,2.19478738,0,15.91220851,15.91220851
50,2,4,31,73,Nebraska,Gosper County,1893,1891,1824,-2,-67,4,23,9,37,-5,-14,0,0,2,-52,2,-52,1,-1,24,24,24,12.38223419,19.9192463,-7.537012113,0,-27.99461642,-27.99461642
50,2,4,31,75,Nebraska,Grant County,611,611,579,0,-32,3,6,4,5,-1,1,0,0,1,-31,1,-31,0,-2,3,3,3,10.08403361,8.403361345,1.680672269,0,-52.10084034,-52.10084034
50,2,4,31,77,Nebraska,Greeley County,2188,2180,2169,-8,-11,7,20,5,40,2,-20,0,0,-10,10,-10,10,0,-1,35,35,35,9.197516671,18.39503334,-9.19751667,0,4.598758335,4.598758335
50,2,4,31,79,Nebraska,Hall County,62895,62730,61979,-165,-751,214,805,159,629,55,176,0,90,-222,-1010,-222,-920,2,-7,783,783,783,12.91005461,10.08748366,2.822570945,1.443360142,-16.19770826,-14.75434812
50,2,4,31,81,Nebraska,Hamilton County,9429,9403,9386,-26,-17,18,88,25,112,-7,-24,0,0,-19,6,-19,6,0,1,106,106,106,9.367182926,11.92186918,-2.554686253,0,0.638671563,0.638671563
50,2,4,31,83,Nebraska,Harlan County,3073,3054,3091,-19,37,8,32,11,44,-3,-12,0,0,-15,48,-15,48,-1,1,20,20,20,10.41497152,14.32058584,-3.905614321,0,15.62245728,15.62245728
50,2,4,31,85,Nebraska,Hayes County,856,855,843,-1,-12,0,11,1,8,-1,3,0,0,1,-15,1,-15,-1,0,0,0,0,12.95641932,9.422850412,3.533568905,0,-17.66784452,-17.66784452
50,2,4,31,87,Nebraska,Hitchcock County,2616,2610,2586,-6,-24,7,20,20,43,-13,-23,0,0,7,-1,7,-1,0,0,13,13,13,7.698229407,16.55119323,-8.852963818,0,-0.38491147,-0.38491147
50,2,4,31,89,Nebraska,Holt County,10127,10083,10049,-44,-34,28,134,34,136,-6,-2,0,5,-38,-38,-38,-33,0,1,82,82,82,13.31213988,13.51082853,-0.198688655,0.496721637,-3.775084443,-3.278362805
50,2,4,31,91,Nebraska,Hooker County,711,707,734,-4,27,2,5,2,8,0,-3,0,0,-4,32,-4,32,0,-2,23,23,23,6.93962526,11.10340042,-4.163775156,0,44.41360167,44.41360167
50,2,4,31,93,Nebraska,Howard County,6475,6496,6531,21,35,19,70,15,80,4,-10,0,1,16,45,16,46,1,-1,47,47,47,10.74691026,12.28218316,-1.535272895,0.15352729,6.908728026,7.062255316
50,2,4,31,95,Nebraska,Jefferson County,7240,7260,7176,20,-84,24,85,26,114,-2,-29,0,1,22,-56,22,-55,0,0,85,85,85,11.77611527,15.79384871,-4.017733444,0.138542533,-7.758381823,-7.619839291
50,2,4,31,97,Nebraska,Johnson County,5290,5288,5316,-2,28,12,39,16,59,-4,-20,0,1,2,48,2,49,0,-1,1072,1072,1072,7.355714825,11.12787627,-3.772161449,0.188608072,9.053187476,9.241795549
50,2,4,31,99,Nebraska,Kearney County,6688,6695,6674,7,-21,27,73,25,63,2,10,0,6,6,-38,6,-32,-1,1,57,57,57,10.9207869,9.42478869,1.495998205,0.897598923,-5.684793178,-4.787194255
50,2,4,31,101,Nebraska,Keith County,8335,8322,8279,-13,-43,17,90,21,107,-4,-17,0,-1,-8,-26,-8,-27,-1,1,28,28,28,10.84272032,12.89078971,-2.048069393,-0.12047467,-3.132341425,-3.252816095
50,2,4,31,103,Nebraska,Keya Paha County,769,763,787,-6,24,3,4,3,9,0,-5,0,0,-5,30,-5,30,-1,-1,0,0,0,5.161290323,11.61290323,-6.451612903,0,38.70967742,38.70967742
50,2,4,31,105,Nebraska,Kimball County,3434,3401,3412,-33,11,6,31,18,50,-12,-19,0,1,-21,29,-21,30,0,0,33,33,33,9.100249523,14.67782181,-5.577572288,0.293556436,8.513136651,8.806693087
50,2,4,31,107,Nebraska,Knox County,8391,8383,8401,-8,18,37,102,35,141,2,-39,0,1,-9,56,-9,57,-1,0,175,175,175,12.15443279,16.80171592,-4.647283127,0.119161106,6.673021926,6.792183032
50,2,4,31,109,Nebraska,Lancaster County,322608,322910,324514,302,1604,942,3558,714,2573,228,985,5,182,64,365,69,547,5,72,15199,15199,15199,10.99125148,7.94842329,3.042828193,0.562228153,1.127545473,1.689773626
50,2,4,31,111,Nebraska,Lincoln County,34676,34551,34133,-125,-418,107,344,116,436,-9,-92,0,10,-114,-336,-114,-326,-2,0,448,448,448,10.01688894,12.69582436,-2.678935414,0.291188632,-9.783938035,-9.492749403
50,2,4,31,113,Nebraska,Logan County,716,714,687,-2,-27,5,4,5,7,0,-3,0,2,-3,-25,-3,-23,1,-1,0,0,0,5.710206995,9.992862241,-4.282655246,2.855103498,-35.68879372,-32.83369022
50,2,4,31,115,Nebraska,Loup County,607,606,604,-1,-2,1,7,1,1,0,6,0,0,-1,-7,-1,-7,0,-1,0,0,0,11.57024793,1.652892562,9.917355372,0,-11.57024793,-11.57024793
50,2,4,31,117,Nebraska,McPherson County,399,396,379,-3,-17,0,3,0,7,0,-4,0,0,-3,-12,-3,-12,0,-1,0,0,0,7.741935484,18.06451613,-10.32258065,0,-30.96774194,-30.96774194
50,2,4,31,119,Nebraska,Madison County,35585,35473,35337,-112,-136,107,459,117,375,-10,84,0,12,-103,-235,-103,-223,1,3,1175,1175,1175,12.96427058,10.59172433,2.372546251,0.338935179,-6.637480582,-6.298545403
50,2,4,31,121,Nebraska,Merrick County,7668,7659,7665,-9,6,19,86,25,101,-6,-15,0,2,-2,18,-2,20,-1,1,139,139,139,11.22422344,13.18193683,-1.957713391,0.261028452,2.349256069,2.610284521
50,2,4,31,123,Nebraska,Morrill County,4555,4539,4574,-16,35,14,55,27,50,-13,5,0,1,-4,30,-4,31,1,-1,62,62,62,12.07066828,10.9733348,1.09733348,0.219466696,6.584000878,6.803467574
50,2,4,31,125,Nebraska,Nance County,3380,3382,3390,2,8,8,38,17,41,-9,-3,0,0,12,11,12,11,-1,0,94,94,94,11.22268163,12.10868281,-0.886001181,0,3.248670998,3.248670998
50,2,4,31,127,Nebraska,Nemaha County,7074,7088,7064,14,-24,21,73,21,91,0,-18,0,1,15,-8,15,-7,-1,1,486,486,486,10.31656303,12.86037309,-2.543810062,0.141322781,-1.13058225,-0.989259469
50,2,4,31,129,Nebraska,Nuckolls County,4095,4081,4060,-14,-21,6,41,20,80,-14,-39,0,1,0,19,0,20,0,-2,31,31,31,10.07247267,19.65360521,-9.581132539,0.245670065,4.667731237,4.913401302
50,2,4,31,131,Nebraska,Otoe County,15912,15892,15930,-20,38,45,166,54,189,-9,-23,0,11,-10,47,-10,58,-1,3,189,189,189,10.43303375,11.87857457,-1.445540821,0.69134561,2.953931243,3.645276853
50,2,4,31,133,Nebraska,Pawnee County,2544,2536,2548,-8,12,4,31,4,38,0,-7,0,0,-8,20,-8,20,0,-1,17,17,17,12.19512195,14.94885917,-2.753737215,0,7.867820614,7.867820614
50,2,4,31,135,Nebraska,Perkins County,2858,2851,2832,-7,-19,5,31,7,23,-2,8,0,0,-4,-27,-4,-27,-1,0,22,22,22,10.90973078,8.094316382,2.815414394,0,-9.502023579,-9.502023579
50,2,4,31,137,Nebraska,Phelps County,8968,8968,8937,0,-31,25,93,25,116,0,-23,0,2,0,-11,0,-9,0,1,205,205,205,10.38815973,12.9572745,-2.569114772,0.223401285,-1.228707065,-1.005305781
50,2,4,31,139,Nebraska,Pierce County,7317,7328,7313,11,-15,23,98,16,76,7,22,0,0,6,-40,6,-40,-2,3,95,95,95,13.38706373,10.38180452,3.005259204,0,-5.464107643,-5.464107643
50,2,4,31,141,Nebraska,Platte County,34296,34280,34241,-16,-39,122,461,79,351,43,110,0,28,-59,-182,-59,-154,0,5,412,412,412,13.4557289,10.24503437,3.210694532,0.817267699,-5.312240043,-4.494972344
50,2,4,31,143,Nebraska,Polk County,5214,5225,5174,11,-51,14,49,18,96,-4,-47,0,0,15,-4,15,-4,0,0,79,79,79,9.423983075,18.46331378,-9.039330705,0,-0.769304741,-0.769304741
50,2,4,31,145,Nebraska,Red Willow County,10702,10671,10623,-31,-48,33,124,37,155,-4,-31,0,2,-26,-21,-26,-19,-1,2,387,387,387,11.64647319,14.55809148,-2.911618296,0.187846342,-1.972386588,-1.784540246
50,2,4,31,147,Nebraska,Richardson County,7871,7836,7759,-35,-77,18,79,48,146,-30,-67,0,0,-4,-10,-4,-10,-1,0,105,105,105,10.13145239,18.72394998,-8.592497595,0,-1.282462328,-1.282462328
50,2,4,31,149,Nebraska,Rock County,1262,1267,1264,5,-3,8,9,5,17,3,-8,0,0,3,6,3,6,-1,-1,12,12,12,7.111813512,13.43342552,-6.321612011,0,4.741209008,4.741209008
50,2,4,31,151,Nebraska,Saline County,14292,14249,14192,-43,-57,53,184,27,120,26,64,1,23,-71,-146,-70,-123,1,2,835,835,835,12.93906684,8.438521852,4.500544988,1.617383355,-10.26686825,-8.649484899
50,2,4,31,153,Nebraska,Sarpy County,190604,191114,193418,510,2304,660,2310,325,1426,335,884,1,14,163,1381,164,1395,11,25,1001,1001,1001,12.01460477,7.416807964,4.597796802,0.072815787,7.182757222,7.255573008
50,2,4,31,155,Nebraska,Saunders County,22278,22361,22787,83,426,78,237,79,260,-1,-23,0,0,85,454,85,454,-1,-5,316,316,316,10.49880393,11.5176752,-1.018871268,0,20.11163285,20.11163285
50,2,4,31,157,Nebraska,Scotts Bluff County,36084,36002,35745,-82,-257,106,409,141,487,-35,-78,0,3,-46,-185,-46,-182,-1,3,723,723,723,11.40117357,13.57548051,-2.17430694,0.08362719,-5.157010049,-5.073382859
50,2,4,31,159,Nebraska,Seward County,17609,17605,17603,-4,-2,48,168,35,184,13,-16,-1,0,-15,9,-16,9,-1,5,1224,1224,1224,9.543285617,10.45216996,-0.908884344,0,0.511247444,0.511247444
50,2,4,31,161,Nebraska,Sheridan County,5127,5097,5095,-30,-2,9,50,18,75,-9,-25,0,1,-20,22,-20,23,-1,0,118,118,118,9.811616955,14.71742543,-4.905808477,0.196232339,4.31711146,4.513343799
50,2,4,31,163,Nebraska,Sherman County,2959,2956,2964,-3,8,10,26,15,52,-5,-26,0,0,3,34,3,34,-1,0,38,38,38,8.783783784,17.56756757,-8.783783784,0,11.48648649,11.48648649
50,2,4,31,165,Nebraska,Sioux County,1135,1144,1143,9,-1,1,5,0,12,1,-7,0,1,9,4,9,5,-1,1,0,0,0,4.372540446,10.49409707,-6.121556624,0.874508089,3.498032357,4.372540446
50,2,4,31,167,Nebraska,Stanton County,5842,5824,5816,-18,-8,17,63,12,67,5,-4,0,2,-23,-7,-23,-5,0,1,0,0,0,10.82474227,11.51202749,-0.687285223,0.343642612,-1.202749141,-0.859106529
50,2,4,31,169,Nebraska,Thayer County,5034,5013,4913,-21,-100,9,42,21,63,-12,-21,0,0,-8,-78,-8,-78,-1,-1,61,61,61,8.462623413,12.69393512,-4.231311707,0,-15.71630062,-15.71630062
50,2,4,31,171,Nebraska,Thomas County,669,671,673,2,2,0,6,0,6,0,0,0,0,3,3,3,3,-1,-1,2,2,2,8.928571429,8.928571429,0,0,4.464285714,4.464285714
50,2,4,31,173,Nebraska,Thurston County,6773,6769,6620,-4,-149,47,117,38,89,9,28,0,1,-14,-175,-14,-174,1,-3,18,18,18,17.47703339,13.29449548,4.182537904,0.149376354,-26.1408619,-25.99148555
50,2,4,31,175,Nebraska,Valley County,4059,4048,4066,-11,18,9,54,19,52,-10,2,0,1,0,15,0,16,-1,0,21,21,21,13.31032783,12.81735272,0.492975105,0.246487552,3.697313286,3.943800838
50,2,4,31,177,Nebraska,Washington County,20865,20904,20969,39,65,45,212,57,222,-12,-10,0,1,51,71,51,72,0,3,97,97,97,10.12585676,10.60349151,-0.477634753,0.047763475,3.391206744,3.43897022
50,2,4,31,179,Nebraska,Wayne County,9697,9687,9784,-10,97,24,98,26,61,-2,37,0,4,-8,53,-8,57,0,3,1118,1118,1118,10.06625238,6.265728519,3.800523856,0.410867444,5.443993632,5.854861075
50,2,4,31,181,Nebraska,Webster County,3395,3387,3411,-8,24,15,37,16,39,-1,-2,0,0,-7,28,-7,28,0,-2,133,133,133,10.88555458,11.47396293,-0.588408355,0,8.237716976,8.237716976
50,2,4,31,183,Nebraska,Wheeler County,774,773,795,-1,22,2,15,3,4,-1,11,0,0,0,11,0,11,0,0,0,0,0,19.13265306,5.102040816,14.03061225,0,14.03061225,14.03061225
50,2,4,31,185,Nebraska,York County,14125,14084,14244,-41,160,37,139,47,146,-10,-7,0,0,-31,168,-31,168,0,-1,761,761,761,9.813611974,10.30782265,-0.494210675,0,11.8610562,11.8610562
40,4,8,32,0,Nevada,Nevada,3104614,3114071,3143991,9457,29920,8193,33883,7894,31808,299,2075,136,2189,8953,25327,9089,27516,69,329,34820,34820,34820,10.82859198,10.16544739,0.663144597,0.699577601,8.094199131,8.793776732
50,4,8,32,1,Nevada,Churchill County,25516,25539,25723,23,184,63,304,100,326,-37,-22,0,5,60,201,60,206,0,0,290,290,290,11.86063751,12.71897312,-0.858335609,0.195076275,7.842066248,8.037142523
50,4,8,32,3,Nevada,Clark County,2265461,2273386,2292476,7925,19090,6101,25488,5482,22163,619,3325,135,2036,7086,13359,7221,15395,85,370,21145,21145,21145,11.16459499,9.708133973,1.456461014,0.891835978,5.851688027,6.743524005
50,4,8,32,5,Nevada,Douglas County,49488,49468,49870,-20,402,75,327,174,665,-99,-338,0,2,87,744,87,746,-8,-6,200,200,200,6.583583322,13.38863275,-6.805049427,0.040266565,14.97916205,15.01942862
50,4,8,32,7,Nevada,Elko County,53702,53750,53915,48,165,187,667,80,436,107,231,0,-5,-62,-74,-62,-79,3,13,717,717,717,12.39028468,8.099196582,4.291088097,-0.092880695,-1.374634282,-1.467514977
50,4,8,32,9,Nevada,Esmeralda County,729,730,743,1,13,1,4,3,4,-2,0,0,1,2,12,2,13,1,0,0,0,0,5.431093008,5.431093008,0,1.357773252,16.29327902,17.65105227
50,4,8,32,11,Nevada,Eureka County,1855,1847,1903,-8,56,4,16,9,16,-5,0,0,0,-3,56,-3,56,0,0,0,0,0,8.533333333,8.533333333,0,0,29.86666667,29.86666667
50,4,8,32,13,Nevada,Humboldt County,17285,17283,17648,-2,365,54,228,45,145,9,83,0,5,-12,279,-12,284,1,-2,140,140,140,13.05430706,8.302081246,4.752225817,0.286278664,15.97434943,16.2606281
50,4,8,32,15,Nevada,Lander County,5734,5725,5798,-9,73,14,81,16,45,-2,36,0,0,-6,35,-6,35,-1,2,15,15,15,14.05883884,7.810466025,6.24837282,0,6.074806908,6.074806908
50,4,8,32,17,Nevada,Lincoln County,4499,4502,4525,3,23,12,49,17,67,-5,-18,0,0,8,42,8,42,0,-1,155,155,155,10.85631993,14.84435582,-3.988035892,0,9.305417082,9.305417082
50,4,8,32,19,Nevada,Lyon County,59235,59431,60903,196,1472,153,578,190,794,-37,-216,-1,-6,236,1717,235,1711,-2,-23,347,347,347,9.606594977,13.19660279,-3.590007812,-0.099722439,28.53723802,28.43751558
50,4,8,32,21,Nevada,Mineral County,4554,4553,4586,-1,33,10,40,24,127,-14,-87,0,0,14,121,14,121,-1,-1,46,46,46,8.753692964,27.79297516,-19.0392822,0,26.47992122,26.47992122
50,4,8,32,23,Nevada,Nye County,51591,51968,53450,377,1482,86,389,219,1010,-133,-621,-1,-10,518,2144,517,2134,-7,-31,1083,1083,1083,7.380143809,19.16181297,-11.78166916,-0.189720921,40.67616536,40.48644444
50,4,8,32,27,Nevada,Pershing County,6650,6639,6741,-11,102,14,51,20,56,-6,-5,0,0,-5,107,-5,107,0,0,1701,1701,1701,7.623318386,8.370702541,-0.747384155,0,15.99402093,15.99402093
50,4,8,32,29,Nevada,Storey County,4104,4106,4143,2,37,5,23,10,43,-5,-20,0,0,8,59,8,59,-1,-2,2,2,2,5.576433507,10.42550612,-4.849072615,0,14.30476421,14.30476421
50,4,8,32,31,Nevada,Washoe County,486492,487388,493392,896,6004,1225,5024,1227,4959,-2,65,3,147,893,5782,896,5929,2,10,5242,5242,5242,10.24490712,10.11235955,0.132547564,0.299761414,11.79061563,12.09037705
50,4,8,32,33,Nevada,White Pine County,9080,9079,9182,-1,103,21,99,34,99,-13,0,0,0,12,103,12,103,0,0,1002,1002,1002,10.84277969,10.84277969,0,0,11.2808718,11.2808718
50,4,8,32,510,Nevada,Carson City,58639,58677,58993,38,316,168,515,244,853,-76,-338,0,14,117,640,117,654,-3,0,2735,2735,2735,8.753293108,14.49817286,-5.744879748,0.237953599,10.87787881,11.11583241
40,1,1,33,0,New Hampshire,New Hampshire,1377529,1377848,1388992,319,11144,2913,11414,3659,15158,-746,-3744,59,1243,1067,13608,1126,14851,-61,37,39476,39476,39476,8.250567434,10.95690391,-2.70633647,0.898497925,9.836492172,10.7349901
50,1,1,33,1,New Hampshire,Belknap County,63705,63743,64460,38,717,104,475,192,956,-88,-481,1,18,129,1192,130,1210,-4,-12,987,987,987,7.410123008,14.91384757,-7.503724562,0.280804661,18.59550869,18.87631335
50,1,1,33,3,New Hampshire,Carroll County,50107,50212,51500,105,1288,71,301,139,701,-68,-400,0,2,182,1712,182,1714,-9,-26,358,358,358,5.91867233,13.78401762,-7.865345289,0.039326726,33.66367784,33.70300456
50,1,1,33,5,New Hampshire,Cheshire County,76458,76501,77329,43,828,156,600,208,883,-52,-283,0,15,101,1105,101,1120,-6,-9,3862,3862,3862,7.800819086,11.48020542,-3.679386336,0.195020477,14.36650848,14.56152896
50,1,1,33,7,New Hampshire,Coos County,31268,31173,31289,-95,116,65,220,145,491,-80,-271,0,8,-11,381,-11,389,-4,-2,2052,2052,2052,7.044282924,15.72155871,-8.677275784,0.256155743,12.19941725,12.45557299
50,1,1,33,9,New Hampshire,Grafton County,91118,91123,92201,5,1078,165,655,237,1014,-72,-359,2,130,82,1313,84,1443,-7,-6,7005,7005,7005,7.145818333,11.06238136,-3.916563025,1.41825402,14.3243656,15.74261962
50,1,1,33,11,New Hampshire,Hillsborough County,422937,422705,424079,-232,1374,978,3990,1079,4325,-101,-335,47,666,-172,959,-125,1625,-6,84,7451,7451,7451,9.423890862,10.21511979,-0.791228932,1.573010355,2.265040435,3.83805079
50,1,1,33,13,New Hampshire,Merrimack County,153808,153922,155238,114,1316,325,1167,424,1678,-99,-511,5,160,214,1666,219,1826,-6,1,6436,6436,6436,7.549488938,10.8552206,-3.30573166,1.035062751,10.77759089,11.81265364
50,1,1,33,15,New Hampshire,Rockingham County,314176,314430,316947,254,2517,657,2575,780,3284,-123,-709,-1,95,392,3126,391,3221,-14,5,2274,2274,2274,8.156774795,10.40265958,-2.245884788,0.300929556,9.902166218,10.20309577
50,1,1,33,17,New Hampshire,Strafford County,130889,131006,132416,117,1410,307,1096,318,1323,-11,-227,5,144,123,1488,128,1632,0,5,8439,8439,8439,8.321248795,10.04471912,-1.723470325,1.093302761,11.29746187,12.39076463
50,1,1,33,19,New Hampshire,Sullivan County,43063,43033,43533,-30,500,85,335,137,503,-52,-168,0,5,27,666,27,671,-5,-3,612,612,612,7.739759259,11.62119077,-3.881431509,0.115518795,15.38710348,15.50262228
40,1,2,34,0,New Jersey,New Jersey,9288994,9279743,9267130,-9251,-12613,24180,95254,22016,90557,2164,4697,791,10014,-12188,-27766,-11397,-17752,-18,442,182896,182896,182896,10.27170456,9.765204086,0.506500476,1.079858583,-2.994143541,-1.914284958
50,1,2,34,1,New Jersey,Atlantic County,274534,274191,274966,-343,775,648,2740,790,3193,-142,-453,1,179,-191,1005,-190,1184,-11,44,6033,6033,6033,9.978931344,11.62873277,-1.649801423,0.651908289,3.660155475,4.312063763
50,1,2,34,3,New Jersey,Bergen County,955732,954774,953819,-958,-955,2225,8424,2101,8675,124,-251,110,869,-1178,-1737,-1068,-868,-14,164,10231,10231,10231,8.827445139,9.090466118,-0.263020979,0.91061845,-1.820189008,-0.909570558
50,1,2,34,5,New Jersey,Burlington County,461860,461862,464269,2,2407,1052,4220,1116,4682,-64,-462,2,163,78,2666,80,2829,-14,40,11945,11945,11945,9.113181613,10.11088064,-0.99769903,0.352002039,5.757284877,6.109286915
50,1,2,34,7,New Jersey,Camden County,523485,523204,523771,-281,567,1379,5760,1363,5579,16,181,16,306,-313,-36,-297,270,0,116,7389,7389,7389,11.00312806,10.65737004,0.345758017,0.584541178,-0.06876955,0.515771628
50,1,2,34,9,New Jersey,Cape May County,95263,95077,95661,-186,584,196,749,327,1430,-131,-681,2,5,-42,1267,-40,1272,-15,-7,2704,2704,2704,7.853705082,14.99439021,-7.140685128,0.052427938,13.28523944,13.33766738
50,1,2,34,11,New Jersey,Cumberland County,154152,153848,153627,-304,-221,458,1719,414,1690,44,29,9,20,-361,-304,-352,-284,4,34,9015,9015,9015,11.18139686,10.99276364,0.188633222,0.130091877,-1.977396536,-1.847304659
50,1,2,34,13,New Jersey,Essex County,863728,862032,854917,-1696,-7115,2352,9469,2011,8015,341,1454,141,1651,-2214,-10244,-2073,-8593,36,24,24456,24456,24456,11.0300306,9.336328569,1.693702026,1.923178848,-11.93279474,-10.00961589
50,1,2,34,15,New Jersey,Gloucester County,302294,302607,304477,313,1870,687,2777,762,3207,-75,-430,-2,47,395,2237,393,2284,-5,16,4185,4185,4185,9.148651587,10.5652595,-1.416607916,0.15483854,7.3696556,7.524494139
50,1,2,34,17,New Jersey,Hudson County,724854,722655,702463,-2199,-20192,2350,9337,1351,5412,999,3925,185,2281,-3421,-26012,-3236,-23731,38,-386,9852,9852,9852,13.10347634,7.595160541,5.508315803,3.201138432,-36.5050473,-33.30390887
50,1,2,34,19,New Jersey,Hunterdon County,128947,128839,129924,-108,1085,271,948,281,1140,-10,-192,0,62,-91,1223,-91,1285,-7,-8,3812,3812,3812,7.327168104,8.811151517,-1.483983413,0.479202977,9.45266518,9.931868157
50,1,2,34,21,New Jersey,Mercer County,387340,386759,385898,-581,-861,955,3876,806,3620,149,256,35,634,-772,-1820,-737,-1186,7,69,20712,20712,20712,10.03291241,9.370263908,0.662648497,1.641090419,-4.711016661,-3.069926242
50,1,2,34,23,New Jersey,Middlesex County,863162,861908,860807,-1254,-1101,2062,8223,1754,7543,308,680,109,1347,-1689,-3297,-1580,-1950,18,169,23654,23654,23654,9.546558775,8.757107241,0.789451534,1.563810613,-3.827678983,-2.263868371
50,1,2,34,25,New Jersey,Monmouth County,643615,643163,645354,-452,2191,1490,5525,1680,6747,-190,-1222,2,78,-243,3284,-241,3362,-21,51,6578,6578,6578,8.575750262,10.47250444,-1.896754176,0.121069416,5.097332825,5.218402241
50,1,2,34,27,New Jersey,Morris County,509285,509001,510981,-284,1980,1178,4412,1087,4702,91,-290,13,274,-378,1938,-365,2212,-10,58,8602,8602,8602,8.651133059,9.219770545,-0.568637486,0.537264383,3.80006706,4.337331443
50,1,2,34,29,New Jersey,Ocean County,637229,638824,648998,1595,10174,2261,9043,2047,8243,214,800,-1,46,1431,9376,1430,9422,-49,-48,7136,7136,7136,14.04386631,12.80145859,1.242407724,0.071438444,14.56101853,14.63245697
50,1,2,34,31,New Jersey,Passaic County,524118,523100,518117,-1018,-4983,1567,6060,1262,4821,305,1239,77,846,-1416,-7057,-1339,-6211,16,-11,10343,10343,10343,11.64022485,9.260317494,2.379907358,1.625021489,-13.55529155,-11.93027006
50,1,2,34,33,New Jersey,Salem County,64837,64859,65046,22,187,156,645,208,877,-52,-232,0,13,78,402,78,415,-4,4,1222,1222,1222,9.930333705,13.50217467,-3.571840961,0.200146261,6.189138216,6.389284477
50,1,2,34,35,New Jersey,Somerset County,345361,345014,345647,-347,633,741,2958,711,3096,30,-138,20,237,-398,476,-378,713,1,58,5411,5411,5411,8.565707344,8.965324523,-0.399617178,0.686299067,1.378389688,2.064688755
50,1,2,34,37,New Jersey,Sussex County,144221,144082,145543,-139,1461,348,1194,340,1503,8,-309,-1,22,-142,1763,-143,1785,-4,-15,1604,1604,1604,8.245144584,10.37893828,-2.133793699,0.151920587,12.1743634,12.32628399
50,1,2,34,39,New Jersey,Union County,575345,574349,572114,-996,-2235,1584,6273,1315,5221,269,1052,72,886,-1359,-4248,-1287,-3362,22,75,6069,6069,6069,10.94322276,9.10801308,1.835209684,1.545623365,-7.410618572,-5.864995207
50,1,2,34,41,New Jersey,Warren County,109632,109595,110731,-37,1136,220,902,290,1161,-70,-259,1,48,38,1352,39,1400,-6,-5,1943,1943,1943,8.18786707,10.53892868,-2.351061609,0.435717982,12.27272315,12.70844113
40,4,8,35,0,New Mexico,New Mexico,2117522,2117566,2115877,44,-1689,5547,21996,5808,23082,-261,-1086,90,1467,265,-2186,355,-719,-50,116,40898,40898,40898,10.39154183,10.9045994,-0.513057575,0.693052912,-1.032729152,-0.33967624
50,4,8,35,1,New Mexico,Bernalillo County,676444,676581,674393,137,-2188,1706,6602,1775,7387,-69,-785,48,614,168,-2119,216,-1505,-10,102,11310,11310,11310,9.773689205,10.93581372,-1.162124512,0.908973822,-3.136995975,-2.228022153
50,4,8,35,3,New Mexico,Catron County,3579,3612,3731,33,119,5,12,7,35,-2,-23,0,5,36,140,36,145,-1,-3,105,105,105,3.268418902,9.532888465,-6.264469563,1.361841209,38.13155386,39.49339507
50,4,8,35,5,New Mexico,Chaves County,65157,65168,64629,11,-539,204,792,174,832,30,-40,1,24,-20,-530,-19,-506,0,7,1696,1696,1696,12.20367189,12.82001895,-0.616347065,0.369808239,-8.166598612,-7.796790373
50,4,8,35,6,New Mexico,Cibola County,27172,27076,27184,-96,108,80,291,88,351,-8,-60,0,4,-88,162,-88,166,0,2,2588,2588,2588,10.72613343,12.93770734,-2.211573903,0.14743826,5.971249539,6.1186878
50,4,8,35,7,New Mexico,Colfax County,12387,12332,12369,-55,37,24,97,48,163,-24,-66,0,4,-29,101,-29,105,-2,-2,398,398,398,7.853933039,13.19784624,-5.343913202,0.323873527,8.177806567,8.501680094
50,4,8,35,9,New Mexico,Curry County,48430,48325,47999,-105,-326,195,802,125,422,70,380,9,33,-187,-733,-178,-700,3,-6,1366,1366,1366,16.65213239,8.762094597,7.890037789,0.685187492,-15.21946763,-14.53428014
50,4,8,35,11,New Mexico,De Baca County,1698,1678,1680,-20,2,7,9,12,28,-5,-19,0,0,-14,21,-14,21,-1,0,9,9,9,5.360333532,16.67659321,-11.31625968,0,12.50744491,12.50744491
50,4,8,35,13,New Mexico,Doña Ana County,219561,219899,221508,338,1609,599,2506,572,2175,27,331,17,184,294,1057,311,1241,0,37,4170,4170,4170,11.35460018,9.854850512,1.499749664,0.833697699,4.789230801,5.622928499
50,4,8,35,15,New Mexico,Eddy County,62314,62257,60911,-57,-1346,182,842,168,589,14,253,-1,28,-72,-1607,-73,-1579,2,-20,993,993,993,13.67238244,9.564172512,4.108209925,0.454663549,-26.09444011,-25.63977657
50,4,8,35,17,New Mexico,Grant County,28185,28209,27889,24,-320,76,230,97,400,-21,-170,0,2,51,-149,51,-147,-6,-3,574,574,574,8.199935827,14.26075796,-6.060822133,0.07130379,-5.31213234,-5.24082855
50,4,8,35,19,New Mexico,Guadalupe County,4452,4447,4449,-5,2,5,40,11,51,-6,-11,0,0,0,14,0,14,1,-1,574,574,574,8.992805755,11.46582734,-2.473021583,0,3.147482014,3.147482014
50,4,8,35,21,New Mexico,Harding County,657,660,639,3,-21,1,0,0,13,1,-13,0,0,1,-7,1,-7,1,-1,0,0,0,0,20.01539646,-20.01539646,0,-10.77752117,-10.77752117
50,4,8,35,23,New Mexico,Hidalgo County,4178,4149,4074,-29,-75,8,30,14,58,-6,-28,0,0,-23,-47,-23,-47,0,0,61,61,61,7.296607078,14.10677368,-6.810166606,0,-11.43135109,-11.43135109
50,4,8,35,25,New Mexico,Lea County,74455,74586,73004,131,-1582,297,1107,180,612,117,495,2,47,7,-2096,9,-2049,5,-28,2050,2050,2050,15.00101633,8.2932448,6.707771529,0.636899519,-28.40300833,-27.76610881
50,4,8,35,27,New Mexico,Lincoln County,20269,20296,20436,27,140,37,167,63,223,-26,-56,2,5,54,193,56,198,-3,-2,111,111,111,8.199941078,10.94962192,-2.749680841,0.245507218,9.476578611,9.722085829
50,4,8,35,28,New Mexico,Los Alamos County,19419,19424,19330,5,-94,42,161,26,145,16,16,0,35,-11,-149,-11,-114,0,4,73,73,73,8.308819735,7.483098519,0.825721216,1.80626516,-7.689528823,-5.883263663
50,4,8,35,29,New Mexico,Luna County,25427,25420,25532,-7,112,89,377,99,324,-10,53,0,30,5,23,5,53,-2,6,546,546,546,14.79824148,12.7178521,2.080389386,1.177578898,0.902810488,2.080389386
50,4,8,35,31,New Mexico,McKinley County,72902,72630,71780,-272,-850,227,849,274,924,-47,-75,-2,30,-227,-807,-229,-777,4,2,742,742,742,11.75818849,12.79689772,-1.038709231,0.415483692,-11.17651132,-10.76102763
50,4,8,35,33,New Mexico,Mora County,4189,4184,4196,-5,12,12,38,16,46,-4,-8,0,0,-1,20,-1,20,0,0,7,7,7,9.069212411,10.97852029,-1.909307876,0,4.77326969,4.77326969
50,4,8,35,35,New Mexico,Otero County,67839,67861,68537,22,676,209,865,167,761,42,104,6,134,-23,427,-17,561,-3,11,2249,2249,2249,12.68347043,11.15852139,1.524949046,1.964838194,6.261088872,8.225927066
50,4,8,35,37,New Mexico,Quay County,8746,8721,8656,-25,-65,24,82,34,148,-10,-66,0,2,-13,-3,-13,-1,-2,2,22,22,22,9.43776256,17.03401047,-7.596247914,0.230189331,-0.345283996,-0.115094665
50,4,8,35,39,New Mexico,Rio Arriba County,40363,40264,40179,-99,-85,106,393,125,504,-19,-111,1,3,-80,18,-79,21,-1,5,413,413,413,9.770893676,12.53061174,-2.759718061,0.074586975,0.447521848,0.522108822
50,4,8,35,41,New Mexico,Roosevelt County,19191,19118,19019,-73,-99,47,224,50,179,-3,45,0,30,-71,-176,-71,-146,1,2,1091,1091,1091,11.74712222,9.387209272,2.359912945,1.573275297,-9.229881742,-7.656606445
50,4,8,35,43,New Mexico,Sandoval County,148834,149218,151369,384,2151,314,1341,357,1433,-43,-92,4,34,427,2219,431,2253,-4,-10,625,625,625,8.92254156,9.534677148,-0.612135588,0.226224022,14.76444424,14.99066826
50,4,8,35,45,New Mexico,San Juan County,121661,121429,120993,-232,-436,373,1320,370,1440,3,-120,-4,21,-233,-360,-237,-339,2,23,1446,1446,1446,10.89010073,11.88010989,-0.990009158,0.173251603,-2.970027473,-2.79677587
50,4,8,35,47,New Mexico,San Miguel County,27201,27115,27150,-86,35,42,237,78,325,-36,-88,0,23,-48,97,-48,120,-2,3,1217,1217,1217,8.734912006,11.97825486,-3.243342855,0.847691882,3.575048374,4.422740256
50,4,8,35,49,New Mexico,Santa Fe County,154823,154977,155201,154,224,271,1140,351,1542,-80,-402,4,100,249,526,253,626,-19,0,2575,2575,2575,7.350618032,9.942678075,-2.592060043,0.644791056,3.391600952,4.036392007
50,4,8,35,51,New Mexico,Sierra County,11576,11526,11502,-50,-24,19,79,96,270,-77,-191,0,5,29,165,29,170,-2,-3,259,259,259,6.861212437,23.44971339,-16.58850096,0.434253952,14.33038041,14.76463436
50,4,8,35,53,New Mexico,Socorro County,16595,16565,16311,-30,-254,46,181,44,221,2,-40,0,4,-31,-216,-31,-212,-1,-2,543,543,543,11.01107191,13.44445796,-2.433386057,0.243338606,-13.14028471,-12.8969461
50,4,8,35,55,New Mexico,Taos County,34489,34392,34623,-97,231,55,234,124,400,-69,-166,-1,-2,-21,402,-22,400,-6,-3,461,461,461,6.781134536,11.59168297,-4.810548432,-0.057958415,11.64964138,11.59168297
50,4,8,35,57,New Mexico,Torrance County,15045,15051,15307,6,256,45,145,46,181,-1,-36,0,8,8,286,8,294,-1,-2,559,559,559,9.552671454,11.92436919,-2.37169774,0.527043942,18.84182094,19.36886488
50,4,8,35,59,New Mexico,Union County,4079,4067,4107,-12,40,11,34,18,41,-7,-7,0,3,-5,45,-5,48,0,-1,663,663,663,8.319060436,10.03180817,-1.712747737,0.734034744,11.01052117,11.74455591
50,4,8,35,61,New Mexico,Valencia County,76205,76329,77190,124,861,189,769,199,859,-10,-90,4,57,133,897,137,954,-3,-3,1402,1402,1402,10.01830392,11.19079723,-1.172493307,0.742579094,11.68584996,12.42842905
40,1,2,36,0,New York,New York,20201249,20154933,19835913,-46316,-319020,53740,210640,46447,192137,7293,18503,553,18307,-54072,-352185,-53519,-333878,-90,-3645,570005,570005,570005,10.5344108,9.609049031,0.925361769,0.915559526,-17.6132808,-16.69772127
50,1,2,36,1,New York,Albany County,314848,314368,313743,-480,-625,691,2795,794,3197,-103,-402,9,275,-380,-561,-371,-286,-6,63,17061,17061,17061,8.899700849,10.17972938,-1.28002853,0.875641407,-1.786308471,-0.910667064
50,1,2,36,3,New York,Allegany County,46456,46373,46106,-83,-267,115,453,118,578,-3,-125,0,6,-77,-156,-77,-150,-3,8,4105,4105,4105,9.796818737,12.50013517,-2.703316429,0.129759189,-3.373738903,-3.243979714
50,1,2,36,5,New York,Bronx County,1472654,1466438,1424948,-6216,-41490,4494,18196,2937,12645,1557,5551,242,3532,-8113,-49840,-7871,-46308,98,-733,45511,45511,45511,12.58635132,8.746670282,3.839681039,2.443118975,-34.47481588,-32.03169691
50,1,2,36,7,New York,Broome County,198683,198199,197240,-484,-959,481,1892,663,2454,-182,-562,1,114,-295,-549,-294,-435,-8,38,11342,11342,11342,9.569111797,12.41152238,-2.842410587,0.57657439,-2.776660876,-2.200086486
50,1,2,36,9,New York,Cattaraugus County,77042,76907,76426,-135,-481,187,790,246,989,-59,-199,1,3,-73,-298,-72,-295,-4,13,2514,2514,2514,10.30437023,12.90002804,-2.595657817,0.03913052,-3.886964972,-3.847834452
50,1,2,36,11,New York,Cayuga County,76248,76095,75880,-153,-215,182,720,236,857,-54,-137,0,7,-95,-96,-95,-89,-4,11,3613,3613,3613,9.475242639,11.27817075,-1.802928113,0.092120415,-1.263365685,-1.171245271
50,1,2,36,13,New York,Chautauqua County,127657,127424,126807,-233,-617,318,1257,433,1691,-115,-434,1,26,-111,-231,-110,-205,-8,22,5619,5619,5619,9.888644579,13.30286236,-3.414217778,0.204538392,-1.817244947,-1.612706554
50,1,2,36,15,New York,Chemung County,84148,83882,83045,-266,-837,219,839,319,1193,-100,-354,0,11,-163,-502,-163,-491,-3,8,3515,3515,3515,10.05229831,14.29367328,-4.241374972,0.131794138,-6.014605187,-5.882811049
50,1,2,36,17,New York,Chenango County,47220,47073,46537,-147,-536,112,427,159,661,-47,-234,0,3,-97,-310,-97,-307,-3,5,655,655,655,9.122956949,14.12242282,-4.999465869,0.064095716,-6.623224015,-6.559128298
50,1,2,36,19,New York,Clinton County,79843,79715,79596,-128,-119,186,673,260,880,-74,-207,1,13,-52,58,-51,71,-3,17,5940,5940,5940,8.448883002,11.04757361,-2.598690611,0.163202792,0.728135534,0.891338326
50,1,2,36,21,New York,Columbia County,61570,61550,61778,-20,228,122,440,179,836,-57,-396,-1,20,46,605,45,625,-8,-1,1833,1833,1833,7.135443695,13.55734302,-6.421899325,0.32433835,9.81123508,10.13557343
50,1,2,36,23,New York,Cortland County,46809,46723,46311,-86,-412,118,427,142,528,-24,-101,0,4,-61,-321,-61,-317,-1,6,3549,3549,3549,9.179439775,11.350689,-2.171249221,0.085990068,-6.900702969,-6.814712901
50,1,2,36,25,New York,Delaware County,44308,44186,44378,-122,192,76,335,145,673,-69,-338,0,12,-47,521,-47,533,-6,-3,2289,2289,2289,7.565150626,15.19804887,-7.632898243,0.27099047,11.76550291,12.03649338
50,1,2,36,27,New York,Dutchess County,295911,295742,297112,-169,1370,672,2583,736,3186,-64,-603,-1,131,-94,1821,-95,1952,-10,21,19291,19291,19291,8.713781133,10.74800879,-2.034227651,0.441930054,6.143165096,6.58509515
50,1,2,36,29,New York,Erie County,954236,953254,950683,-982,-2571,2424,9257,2891,11543,-467,-2286,45,633,-527,-1121,-482,-488,-33,203,27622,27622,27622,9.724061248,12.12540121,-2.40133996,0.664937968,-1.177559972,-0.512622004
50,1,2,36,31,New York,Essex County,37381,37336,37268,-45,-68,79,298,135,530,-56,-232,0,10,16,152,16,162,-5,2,2053,2053,2053,7.988847783,14.20835344,-6.219505657,0.26808214,4.074848534,4.342930674
50,1,2,36,33,New York,Franklin County,47555,47527,47456,-28,-71,113,389,131,595,-18,-206,0,-1,-8,126,-8,125,-2,10,5643,5643,5643,8.190939431,12.52855774,-4.337618311,-0.0210564,2.653106345,2.632049946
50,1,2,36,35,New York,Fulton County,53324,53160,53116,-164,-44,132,458,190,681,-58,-223,0,2,-104,171,-104,173,-2,6,1267,1267,1267,8.619067334,12.81568746,-4.196620121,0.037637849,3.218036057,3.255673906
50,1,2,36,37,New York,Genesee County,58388,58258,57853,-130,-405,147,524,191,783,-44,-259,0,3,-85,-158,-85,-155,-1,9,1932,1932,1932,9.025845958,13.48709425,-4.461248288,0.051674691,-2.721533705,-2.669859014
50,1,2,36,39,New York,Greene County,47931,47890,48499,-41,609,100,365,163,637,-63,-272,0,6,27,883,27,889,-5,-8,3000,3000,3000,7.573478302,13.21727583,-5.643797529,0.124495534,18.32159271,18.44608825
50,1,2,36,41,New York,Hamilton County,5107,5078,5119,-29,41,8,25,23,69,-15,-44,0,0,-13,87,-13,87,-1,-2,83,83,83,4.903402962,13.53339217,-8.629989213,0,17.06384231,17.06384231
50,1,2,36,43,New York,Herkimer County,60139,60007,59937,-132,-70,124,590,182,771,-58,-181,0,7,-70,97,-70,104,-4,7,1291,1291,1291,9.837924365,12.85599947,-3.018075102,0.116721137,1.617421463,1.7341426
50,1,2,36,45,New York,Jefferson County,116721,116134,116295,-587,161,443,1666,267,1140,176,526,1,-22,-769,-358,-768,-380,5,15,6242,6242,6242,14.33556054,9.809447186,4.526113351,-0.189305121,-3.080510608,-3.269815729
50,1,2,36,47,New York,Kings County,2736074,2727393,2641052,-8681,-86341,8743,35247,4781,20534,3962,14713,-67,2897,-12653,-102352,-12720,-99455,77,-1599,37091,37091,37091,13.13117672,7.649887444,5.481289275,1.079269695,-38.13096716,-37.05169747
50,1,2,36,49,New York,Lewis County,26582,26538,26573,-44,35,80,273,80,356,0,-83,0,5,-44,110,-44,115,0,3,276,276,276,10.28035624,13.40588579,-3.125529551,0.188284913,4.14226808,4.330552993
50,1,2,36,51,New York,Livingston County,61834,61699,61578,-135,-121,142,509,166,727,-24,-218,1,20,-110,69,-109,89,-2,8,5526,5526,5526,8.257825872,11.79457644,-3.53675057,0.324472529,1.119430226,1.443902756
50,1,2,36,53,New York,Madison County,68016,67890,67658,-126,-232,135,618,169,754,-34,-136,0,10,-89,-118,-89,-108,-3,12,4263,4263,4263,9.118541033,11.12521026,-2.006669224,0.147549208,-1.74108065,-1.593531443
50,1,2,36,55,New York,Monroe County,759443,758554,755160,-889,-3394,1993,7530,2088,8172,-95,-642,36,519,-811,-3381,-775,-2862,-19,110,26036,26036,26036,9.949039251,10.79728403,-0.848244781,0.685730594,-4.467158261,-3.781427667
50,1,2,36,57,New York,Montgomery County,49532,49433,49558,-99,125,141,588,167,642,-26,-54,0,22,-72,152,-72,174,-1,5,820,820,820,11.87986787,12.97087614,-1.091008273,0.444484852,3.070986251,3.515471103
50,1,2,36,59,New York,Nassau County,1395774,1393978,1390907,-1796,-3071,3427,13199,3275,13143,152,56,44,574,-1965,-3922,-1921,-3348,-27,221,19443,19443,19443,9.479026962,9.438809861,0.040217101,0.41222528,-2.816633362,-2.404408081
50,1,2,36,61,New York,New York County,1694251,1687834,1576876,-6417,-110958,4112,15643,3045,13412,1067,2231,103,2438,-7583,-113642,-7480,-111204,-4,-1985,70934,70934,70934,9.583087012,8.216349997,1.366737015,1.493547666,-69.61843472,-68.12488705
50,1,2,36,63,New York,Niagara County,212666,212252,211653,-414,-599,543,1944,749,2812,-206,-868,0,35,-197,197,-197,232,-11,37,3620,3620,3620,9.171866338,13.26712353,-4.095257192,0.165131338,0.929453533,1.094584872
50,1,2,36,65,New York,Oneida County,232125,231695,230274,-430,-1421,590,2402,774,2982,-184,-580,4,140,-240,-1010,-236,-870,-10,29,12716,12716,12716,10.39896616,12.90995716,-2.510990997,0.606101275,-4.372587771,-3.766486496
50,1,2,36,67,New York,Onondaga County,476516,475653,473236,-863,-2417,1239,4755,1332,5158,-93,-403,13,433,-776,-2509,-763,-2076,-7,62,16932,16932,16932,10.02224707,10.87166149,-0.84941442,0.912646263,-5.288289779,-4.375643516
50,1,2,36,69,New York,Ontario County,112458,112475,112508,17,33,266,909,307,1315,-41,-406,0,29,67,394,67,423,-9,16,3166,3166,3166,8.080610535,11.68977212,-3.609161581,0.257797256,3.502486855,3.76028411
50,1,2,36,71,New York,Orange County,401310,401322,404525,12,3203,1294,4975,846,3347,448,1628,7,114,-458,1410,-451,1524,15,51,11228,11228,11228,12.34725699,8.306787765,4.040469221,0.28293212,3.499423588,3.782355708
50,1,2,36,73,New York,Orleans County,40343,40236,40191,-107,-45,92,404,126,505,-34,-101,0,6,-72,44,-72,50,-1,6,2420,2420,2420,10.04637746,12.55797183,-2.511594365,0.149203626,1.094159921,1.243363547
50,1,2,36,75,New York,Oswego County,117525,117351,117387,-174,36,324,1178,337,1352,-13,-174,0,14,-160,174,-160,188,-1,22,4183,4183,4183,10.03672179,11.51922569,-1.482503898,0.119281923,1.482503898,1.601785821
50,1,2,36,77,New York,Otsego County,58524,58351,58123,-173,-228,115,426,167,741,-52,-315,0,9,-116,71,-116,80,-5,7,5102,5102,5102,7.314937239,12.72386971,-5.408932466,0.154540928,1.219156207,1.373697134
50,1,2,36,79,New York,Putnam County,97668,97660,97936,-8,276,217,776,216,916,1,-140,0,31,-5,375,-5,406,-4,10,2298,2298,2298,7.934722592,9.366244709,-1.431522117,0.316979897,3.834434242,4.151414139
50,1,2,36,81,New York,Queens County,2405464,2395791,2331143,-9673,-64648,6483,25490,4282,18667,2201,6823,-22,3709,-11879,-74129,-11901,-70420,27,-1051,29090,29090,29090,10.78500356,7.898142855,2.886860701,1.569304754,-31.36451662,-29.79521186
50,1,2,36,83,New York,Rensselaer County,161130,160923,160232,-207,-691,407,1510,399,1913,8,-403,2,72,-214,-387,-212,-315,-3,27,5620,5620,5620,9.403559029,11.91325061,-2.509691582,0.448381623,-2.410051221,-1.961669599
50,1,2,36,85,New York,Richmond County,495747,495522,493494,-225,-2028,1273,5069,1068,4815,205,254,1,119,-428,-2486,-427,-2367,-3,85,7005,7005,7005,10.25059251,9.736950666,0.513641842,0.240643225,-5.027218973,-4.786575748
50,1,2,36,87,New York,Rockland County,338329,338121,339227,-208,1106,1374,5458,700,2863,674,2595,1,280,-894,-1810,-893,-1530,11,41,6443,6443,6443,16.11579277,8.453557108,7.66223566,0.826753751,-5.344372464,-4.517618713
50,1,2,36,89,New York,St. Lawrence County,108505,108311,108051,-194,-260,245,937,301,1315,-56,-378,0,32,-135,64,-135,96,-3,22,10423,10423,10423,8.661410044,12.15555412,-3.494144073,0.295800557,0.591601113,0.887401669
50,1,2,36,91,New York,Saratoga County,235509,235689,237359,180,1670,529,1966,551,2472,-22,-506,0,64,213,2101,213,2165,-11,11,3365,3365,3365,8.3120529,10.45137069,-2.139317786,0.270585649,8.882819503,9.153405151
50,1,2,36,93,New York,Schenectady County,158061,157861,158089,-200,228,417,1729,449,1751,-32,-22,-2,91,-163,129,-165,220,-3,30,4439,4439,4439,10.94476974,11.08403228,-0.139262542,0.576040513,0.816584903,1.392625415
50,1,2,36,95,New York,Schoharie County,29714,29720,29863,6,143,66,239,89,388,-23,-149,-1,2,34,290,33,292,-4,0,1109,1109,1109,8.022422503,13.02384908,-5.001426581,0.067133243,9.734320192,9.801453435
50,1,2,36,97,New York,Schuyler County,17898,17857,17752,-41,-105,39,142,53,244,-14,-102,0,2,-25,-7,-25,-5,-2,2,170,170,170,7.975511809,13.70440057,-5.728888764,0.112331152,-0.393159033,-0.280827881
50,1,2,36,99,New York,Seneca County,33814,33715,33688,-99,-27,66,362,100,388,-34,-26,0,9,-63,-17,-63,-8,-2,7,2525,2525,2525,10.74136166,11.51284068,-0.771479014,0.267050428,-0.504428586,-0.237378158
50,1,2,36,101,New York,Steuben County,93584,93363,92948,-221,-415,244,985,304,1226,-60,-241,1,36,-157,-222,-156,-186,-5,12,1470,1470,1470,10.57371814,13.16079029,-2.587072154,0.386450612,-2.383112108,-1.996661496
50,1,2,36,103,New York,Suffolk County,1525920,1524099,1526344,-1821,2245,3585,14600,3806,15459,-221,-859,73,700,-1653,2138,-1580,2838,-20,266,29563,29563,29563,9.572380143,10.13557703,-0.563196886,0.458949733,1.401763613,1.860713346
50,1,2,36,105,New York,Sullivan County,78624,78643,79806,19,1163,207,850,235,895,-28,-45,1,35,50,1183,51,1218,-4,-10,3787,3787,3787,10.72900429,11.2970104,-0.568006109,0.441782529,14.93224949,15.37403202
50,1,2,36,107,New York,Tioga County,48455,48355,47980,-100,-375,111,456,153,577,-42,-121,0,2,-54,-262,-54,-260,-4,6,421,421,421,9.466964239,11.97903151,-2.512067265,0.041521773,-5.43935226,-5.397830487
50,1,2,36,109,New York,Tompkins County,105740,105404,105162,-336,-242,191,661,194,825,-3,-164,0,158,-337,-256,-337,-98,4,20,13418,13418,13418,6.278316537,7.83602291,-1.557706372,1.500717115,-2.431541654,-0.93082454
50,1,2,36,111,New York,Ulster County,181851,181687,182951,-164,1264,382,1493,526,2081,-144,-588,0,85,-6,1764,-6,1849,-14,3,11651,11651,11651,8.188943555,11.41405997,-3.225116417,0.466215809,9.675349251,10.14156506
50,1,2,36,113,New York,Warren County,65737,65638,65618,-99,-20,130,508,207,855,-77,-347,0,8,-14,315,-14,323,-8,4,572,572,572,7.740598525,13.02797586,-5.287377339,0.121899189,4.799780582,4.921679771
50,1,2,36,115,New York,Washington County,61302,61143,60956,-159,-187,150,493,212,786,-62,-293,0,5,-95,91,-95,96,-2,10,2970,2970,2970,8.075414213,12.87479832,-4.799384106,0.081900753,1.490593699,1.572494451
50,1,2,36,117,New York,Wayne County,91283,91103,90923,-180,-180,222,883,268,1062,-46,-179,0,2,-130,-18,-130,-16,-4,15,992,992,992,9.701910716,11.66866272,-1.966752002,0.021974883,-0.197773944,-0.175799062
50,1,2,36,119,New York,Westchester County,1004457,1003245,997895,-1212,-5350,2450,9440,2157,8817,293,623,59,793,-1556,-6882,-1497,-6089,-8,116,28311,28311,28311,9.434622265,8.811977173,0.622645092,0.792548248,-6.878079495,-6.085531247
50,1,2,36,121,New York,Wyoming County,40531,40401,40491,-130,90,95,314,129,413,-34,-99,0,5,-95,180,-95,185,-1,4,3340,3340,3340,7.76343767,10.21114573,-2.447708055,0.123621619,4.450378282,4.573999901
50,1,2,36,123,New York,Yates County,24774,24709,24613,-65,-96,78,280,99,340,-21,-60,0,7,-42,-46,-42,-39,-2,3,1297,1297,1297,11.35395969,13.78695106,-2.432991363,0.283848992,-1.865293378,-1.581444386
40,3,5,37,0,North Carolina,North Carolina,10439388,10457177,10551162,17789,93985,28009,114011,28852,115709,-843,-1698,440,6756,18211,88673,18651,95429,-19,254,260910,260910,260910,10.85388045,11.01553055,-0.161650095,0.64317317,8.441695462,9.084868632
50,3,5,37,1,North Carolina,Alamance County,171415,171842,173877,427,2035,474,1795,569,2076,-95,-281,2,3,520,2319,522,2322,0,-6,6081,6081,6081,10.38415592,12.00975359,-1.625597667,0.017355135,13.41551954,13.43287468
50,3,5,37,3,North Carolina,Alexander County,36444,36430,36644,-14,214,73,337,123,496,-50,-159,0,2,38,371,38,373,-2,0,1327,1327,1327,9.223526836,13.57527985,-4.351753017,0.054739032,10.15409037,10.20882941
50,3,5,37,5,North Carolina,Alleghany County,10888,10899,11049,11,150,21,90,39,180,-18,-90,0,3,29,241,29,244,0,-4,56,56,56,8.201202843,16.40240569,-8.201202843,0.273373428,21.96099872,22.23437215
50,3,5,37,7,North Carolina,Anson County,22055,22030,22060,-25,30,63,253,79,328,-16,-75,0,4,-8,101,-8,105,-1,0,1189,1189,1189,11.47652529,14.87865729,-3.402132003,0.18144704,4.581537764,4.762984804
50,3,5,37,9,North Carolina,Ashe County,26577,26569,26711,-8,142,75,203,114,451,-39,-248,0,1,34,391,34,392,-3,-2,234,234,234,7.62012012,16.92942943,-9.309309309,0.037537538,14.67717718,14.71471472
50,3,5,37,11,North Carolina,Avery County,17806,17798,17864,-8,66,31,137,84,263,-53,-126,-1,3,49,189,48,192,-3,0,2439,2439,2439,7.683248276,14.74959341,-7.066345129,0.168246313,10.59951769,10.76776401
50,3,5,37,13,North Carolina,Beaufort County,44652,44618,44468,-34,-150,119,412,191,705,-72,-293,0,6,43,133,43,139,-5,4,305,305,305,9.249489258,15.82740273,-6.577913477,0.1347013,2.985878814,3.120580114
50,3,5,37,15,North Carolina,Bertie County,17934,17851,17505,-83,-346,50,151,77,300,-27,-149,0,2,-54,-198,-54,-196,-2,-1,1340,1340,1340,8.541690237,16.9702455,-8.428555266,0.11313497,-11.20036203,-11.08722706
50,3,5,37,17,North Carolina,Bladen County,29606,29599,29525,-7,-74,75,345,124,509,-49,-164,1,3,44,83,45,86,-3,4,111,111,111,11.67038766,17.2180502,-5.54766254,0.101481632,2.807658481,2.909140112
50,3,5,37,19,North Carolina,Brunswick County,136693,138084,144215,1391,6131,219,990,445,2273,-226,-1283,-1,-9,1634,7536,1633,7527,-16,-113,563,563,563,7.013839936,16.10349311,-9.089653169,-0.063762181,53.39019975,53.32643757
50,3,5,37,21,North Carolina,Buncombe County,269452,269621,271534,169,1913,541,2321,827,3194,-286,-873,1,127,469,2654,470,2781,-15,5,7930,7930,7930,8.577949017,11.80438137,-3.226432353,0.469366448,9.808650017,10.27801647
50,3,5,37,23,North Carolina,Burke County,87570,87546,87611,-24,65,206,804,323,1237,-117,-433,0,20,99,468,99,488,-6,10,2809,2809,2809,9.180335356,14.12447119,-4.944135832,0.228366551,5.343777297,5.572143848
50,3,5,37,25,North Carolina,Cabarrus County,225804,227065,231278,1261,4213,603,2487,472,2073,131,414,-1,84,1120,3738,1119,3822,11,-23,1500,1500,1500,10.85213476,9.045627401,1.806507354,0.366537724,16.31092872,16.67746644
50,3,5,37,27,North Carolina,Caldwell County,80652,80512,80463,-140,-49,186,755,341,1204,-155,-449,3,10,19,381,22,391,-7,9,782,782,782,9.380338562,14.95884454,-5.578505979,0.124242895,4.733654294,4.857897189
50,3,5,37,29,North Carolina,Camden County,10355,10398,10835,43,437,26,97,29,92,-3,5,0,1,45,440,45,441,1,-9,3,3,3,9.136721142,8.665756134,0.470965007,0.094193002,41.44492064,41.53911364
50,3,5,37,31,North Carolina,Carteret County,67686,67656,68541,-30,885,126,482,267,1099,-141,-617,2,1,118,1521,120,1522,-9,-20,798,798,798,7.077982628,16.13838778,-9.060405148,0.014684611,22.33529373,22.34997834
50,3,5,37,33,North Carolina,Caswell County,22736,22694,22714,-42,20,40,186,79,330,-39,-144,0,5,-1,159,-1,164,-2,0,1152,1152,1152,8.192389006,14.53488372,-6.342494715,0.220225511,7.003171247,7.223396758
50,3,5,37,35,North Carolina,Catawba County,160610,160747,161723,137,976,400,1557,500,2007,-100,-450,-1,46,244,1370,243,1416,-6,10,2400,2400,2400,9.656712252,12.44766955,-2.790957298,0.285297857,8.496914442,8.782212299
50,3,5,37,37,North Carolina,Chatham County,76285,76611,77889,326,1278,167,597,232,949,-65,-352,0,15,398,1628,398,1643,-7,-13,689,689,689,7.72815534,12.28478964,-4.556634304,0.194174757,21.07443366,21.26860841
50,3,5,37,39,North Carolina,Cherokee County,28774,28833,29167,59,334,59,240,118,482,-59,-242,0,0,123,581,123,581,-5,-5,355,355,355,8.275862069,16.62068966,-8.344827586,0,20.03448276,20.03448276
50,3,5,37,41,North Carolina,Chowan County,13708,13666,13722,-42,56,31,131,69,246,-38,-115,0,-1,-3,174,-3,173,-1,-2,184,184,184,9.566233387,17.96407186,-8.397838469,-0.073024682,12.70629473,12.63327005
50,3,5,37,43,North Carolina,Clay County,11089,11118,11309,29,191,20,91,60,188,-40,-97,0,-2,71,293,71,291,-2,-3,69,69,69,8.115218264,16.76550586,-8.6502876,-0.178356445,26.12921925,25.9508628
50,3,5,37,45,North Carolina,Cleveland County,99519,99725,100359,206,634,236,1119,341,1495,-105,-376,0,11,315,997,315,1008,-4,2,1855,1855,1855,11.18530217,14.94372364,-3.758421463,0.109953819,9.965814358,10.07576818
50,3,5,37,47,North Carolina,Columbus County,50623,50505,50092,-118,-413,147,545,220,907,-73,-362,-1,5,-40,-66,-41,-61,-4,10,2377,2377,2377,10.83531318,18.03234689,-7.197033709,0.099406543,-1.312166367,-1.212759824
50,3,5,37,49,North Carolina,Craven County,100720,100552,100674,-168,122,323,1256,309,1286,14,-30,6,-5,-184,151,-178,146,-4,6,4469,4469,4469,12.48347629,12.7816485,-0.298172204,-0.049695367,1.500800095,1.451104728
50,3,5,37,51,North Carolina,Cumberland County,334728,334370,335508,-358,1138,1228,4977,799,3264,429,1713,-5,218,-800,-866,-805,-648,18,73,15702,15702,15702,14.85942216,9.745058055,5.114364108,0.650864784,-2.585545428,-1.934680643
50,3,5,37,53,North Carolina,Currituck County,28100,28385,29653,285,1268,64,276,48,295,16,-19,0,0,268,1309,268,1309,1,-22,55,55,55,9.511010028,10.16575347,-0.654743444,0,45.10837727,45.10837727
50,3,5,37,55,North Carolina,Dare County,36915,37001,37826,86,825,74,309,103,447,-29,-138,0,26,117,949,117,975,-2,-12,99,99,99,8.259050877,11.94755904,-3.688508159,0.69493632,25.36517567,26.06011199
50,3,5,37,57,North Carolina,Davidson County,168930,169131,170637,201,1506,417,1681,525,2242,-108,-561,2,36,312,2035,314,2071,-5,-4,1407,1407,1407,9.894987168,13.19724047,-3.302253302,0.211909303,11.97876198,12.19067128
50,3,5,37,59,North Carolina,Davie County,42712,42806,43533,94,727,91,396,167,539,-76,-143,0,3,173,876,173,879,-3,-9,213,213,213,9.173143076,12.48566696,-3.312523888,0.069493508,20.29210438,20.36159789
50,3,5,37,61,North Carolina,Duplin County,48715,48675,48515,-40,-160,162,666,162,719,0,-53,1,51,-38,-164,-37,-113,-3,6,175,175,175,13.7051137,14.79576088,-1.090647186,1.049490688,-3.374832802,-2.325342113
50,3,5,37,63,North Carolina,Durham County,324833,325602,326126,769,524,964,4002,649,2739,315,1263,50,651,391,-1405,441,-754,13,15,14113,14113,14113,12.28119706,8.405347016,3.875850048,1.997765939,-4.311614661,-2.313848722
50,3,5,37,65,North Carolina,Edgecombe County,48900,48697,48359,-203,-338,130,555,221,758,-91,-203,0,4,-110,-146,-110,-142,-2,7,638,638,638,11.43669634,15.61984834,-4.183151995,0.08242664,-3.008572371,-2.92614573
50,3,5,37,67,North Carolina,Forsyth County,382590,382733,385523,143,2790,1040,4160,1085,4106,-45,54,4,188,187,2508,191,2696,-3,40,10524,10524,10524,10.82972343,10.68914529,0.140578141,0.489420193,6.529073642,7.018493835
50,3,5,37,69,North Carolina,Franklin County,68573,69060,71703,487,2643,187,740,200,800,-13,-60,2,33,495,2707,497,2740,3,-37,1182,1182,1182,10.51412658,11.36662333,-0.85249675,0.468873212,38.4618117,38.93068491
50,3,5,37,71,North Carolina,Gaston County,227943,228269,230856,326,2587,602,2487,764,2911,-162,-424,-2,53,488,2966,486,3019,2,-8,3150,3150,3150,10.83365097,12.68064253,-1.84699156,0.230873945,12.9202287,13.15110264
50,3,5,37,73,North Carolina,Gates County,10478,10452,10366,-26,-86,24,86,41,176,-17,-90,0,1,-9,2,-9,3,0,1,14,14,14,8.262080892,16.90844462,-8.646363724,0.096070708,0.192141416,0.288212124
50,3,5,37,75,North Carolina,Graham County,8030,8016,8043,-14,27,20,87,40,129,-20,-42,0,0,7,68,7,68,-1,1,46,46,46,10.83504577,16.06575752,-5.23071175,0,8.468771405,8.468771405
50,3,5,37,77,North Carolina,Granville County,60992,61041,61986,49,945,140,563,167,687,-27,-124,0,10,78,1065,78,1075,-2,-6,3476,3476,3476,9.152462468,11.16828013,-2.015817666,0.162565941,17.3132727,17.47583864
50,3,5,37,79,North Carolina,Greene County,20451,20444,20417,-7,-27,49,207,60,250,-11,-43,0,4,5,8,5,12,-1,4,2341,2341,2341,10.13191062,12.23660703,-2.10469641,0.195785713,0.391571425,0.587357138
50,3,5,37,81,North Carolina,Guilford County,541299,541347,542410,48,1063,1421,5775,1536,5608,-115,167,35,592,129,186,164,778,-1,118,19854,19854,19854,10.65737061,10.34918344,0.308187167,1.092495827,0.343250378,1.435746205
50,3,5,37,83,North Carolina,Halifax County,48622,48495,48272,-127,-223,129,508,206,816,-77,-308,0,9,-47,68,-47,77,-3,8,1051,1051,1051,10.49944713,16.86525365,-6.365806525,0.186013827,1.405437804,1.591451631
50,3,5,37,85,North Carolina,Harnett County,133568,133761,135966,193,2205,454,1808,305,1325,149,483,-1,22,41,1690,40,1712,4,10,2847,2847,2847,13.4061477,9.824748727,3.58139897,0.163127903,12.53118894,12.69431685
50,3,5,37,87,North Carolina,Haywood County,62089,62131,62476,42,345,124,506,266,961,-142,-455,0,0,190,806,190,806,-6,-6,584,584,584,8.121534103,15.42449461,-7.302960508,0,12.9366729,12.9366729
50,3,5,37,89,North Carolina,Henderson County,116281,116493,116829,212,336,253,991,416,1799,-163,-808,0,2,389,1141,389,1143,-14,1,1027,1027,1027,8.494698314,15.42074901,-6.926050694,0.01714369,9.780475052,9.797618742
50,3,5,37,91,North Carolina,Hertford County,21552,21451,21278,-101,-173,37,199,79,353,-42,-154,0,5,-57,-28,-57,-23,-2,4,2115,2115,2115,9.314517073,16.52273632,-7.208219242,0.234033092,-1.310585317,-1.076552224
50,3,5,37,93,North Carolina,Hoke County,52082,52223,53114,141,891,199,807,110,450,89,357,3,9,44,520,47,529,5,5,642,642,642,15.32225144,8.54400638,6.778245061,0.170880128,9.873074039,10.04395417
50,3,5,37,95,North Carolina,Hyde County,4589,4549,4508,-40,-41,9,31,19,66,-10,-35,0,0,-30,-6,-30,-6,0,0,470,470,470,6.845533841,14.57436237,-7.72882853,0,-1.324942034,-1.324942034
50,3,5,37,97,North Carolina,Iredell County,186693,187630,191968,937,4338,500,1854,506,2026,-6,-172,0,82,940,4475,940,4557,3,-47,1040,1040,1040,9.768228494,10.67445034,-0.906221845,0.432035996,23.57757417,24.00961017
50,3,5,37,99,North Carolina,Jackson County,43109,43134,43410,25,276,76,336,126,450,-50,-114,0,17,76,370,76,387,-1,3,4024,4024,4024,7.764836384,10.39933444,-2.634498059,0.392863746,8.550563875,8.943427621
50,3,5,37,101,North Carolina,Johnston County,215999,217612,226504,1613,8892,560,2481,502,2103,58,378,2,113,1539,8518,1541,8631,14,-117,1246,1246,1246,11.17275667,9.470498699,1.702257969,0.508876059,38.35934756,38.86822362
50,3,5,37,103,North Carolina,Jones County,9172,9156,9255,-16,99,27,77,31,149,-4,-72,0,0,-12,172,-12,172,0,-1,66,66,66,8.364564662,16.18597578,-7.821411113,0,18.6844821,18.6844821
50,3,5,37,105,North Carolina,Lee County,63285,63387,64138,102,751,188,764,175,697,13,67,0,37,91,643,91,680,-2,4,960,960,960,11.98196432,10.93118996,1.050774358,0.580278377,10.0842972,10.66457557
50,3,5,37,107,North Carolina,Lenoir County,55122,54995,54706,-127,-289,146,642,226,855,-80,-213,0,-3,-44,-81,-44,-84,-3,8,902,902,902,11.70454235,15.58782509,-3.883282741,-0.054694123,-1.476741324,-1.531435447
50,3,5,37,109,North Carolina,Lincoln County,86810,87190,89670,380,2480,234,832,247,1112,-13,-280,3,19,390,2775,393,2794,0,-34,557,557,557,9.408571752,12.57491801,-3.166346263,0.214859211,31.38075314,31.59561235
50,3,5,37,111,North Carolina,McDowell County,44578,44536,44717,-42,181,97,394,159,631,-62,-237,0,2,23,416,23,418,-3,0,1392,1392,1392,8.828834885,14.13958074,-5.310745857,0.044816421,9.321815513,9.366631934
50,3,5,37,113,North Carolina,Macon County,37014,37049,37564,35,515,73,313,133,519,-60,-206,0,13,100,717,100,730,-5,-9,289,289,289,8.389958854,13.91178481,-5.521825955,0.348464745,19.21917092,19.56763567
50,3,5,37,115,North Carolina,Madison County,21193,21209,21502,16,293,46,169,70,335,-24,-166,0,5,42,459,42,464,-2,-5,895,895,895,7.913652221,15.68682541,-7.773173187,0.234131723,21.49329213,21.72742385
50,3,5,37,117,North Carolina,Martin County,22031,21949,21754,-82,-195,59,219,93,376,-34,-157,0,0,-45,-41,-45,-41,-3,3,93,93,93,10.02219527,17.20705672,-7.184861451,0,-1.876301398,-1.876301398
50,3,5,37,119,North Carolina,Mecklenburg County,1115482,1118340,1122276,2858,3936,3459,14170,1832,8339,1627,5831,194,2198,960,-4293,1154,-2095,77,200,16646,16646,16646,12.64830743,7.443488755,5.204818675,1.961960461,-3.831981919,-1.870021458
50,3,5,37,121,North Carolina,Mitchell County,14903,14881,14963,-22,82,37,144,70,274,-33,-130,0,5,14,208,14,213,-3,-1,146,146,146,9.650180941,18.36214985,-8.711968905,0.335075727,13.93915025,14.27422598
50,3,5,37,123,North Carolina,Montgomery County,25751,25720,25798,-31,78,63,274,103,346,-40,-72,0,9,11,140,11,149,-2,1,749,749,749,10.63705889,13.43219846,-2.795139563,0.349392445,5.434993595,5.78438604
50,3,5,37,125,North Carolina,Moore County,99727,100168,102763,441,2595,276,1143,374,1393,-98,-250,3,11,543,2870,546,2881,-7,-36,573,573,573,11.2649127,13.72880437,-2.463891668,0.108411233,28.28547634,28.39388758
50,3,5,37,127,North Carolina,Nash County,94970,95027,95176,57,149,237,1036,346,1245,-109,-209,-1,18,170,326,169,344,-3,14,2066,2066,2066,10.89362418,13.09127616,-2.197651982,0.189271463,3.427916489,3.617187952
50,3,5,37,129,North Carolina,New Hanover County,225702,226060,229018,358,2958,495,2075,702,2558,-207,-483,3,91,565,3355,568,3446,-3,-5,7499,7499,7499,9.11931581,11.24202884,-2.122713029,0.39993144,14.74472508,15.14465652
50,3,5,37,131,North Carolina,Northampton County,17471,17438,17129,-33,-309,33,168,67,318,-34,-150,0,5,4,-162,4,-157,-3,-2,278,278,278,9.720253421,18.39905112,-8.678797697,0.289293257,-9.373101513,-9.083808256
50,3,5,37,133,North Carolina,Onslow County,204576,204735,206160,159,1425,886,3599,394,1397,492,2202,21,-154,-367,-650,-346,-804,13,27,25150,25150,25150,17.51785736,6.799790701,10.71806666,-0.749583227,-3.163825308,-3.913408535
50,3,5,37,135,North Carolina,Orange County,148696,148792,148884,96,92,276,1089,250,1064,26,25,-1,200,70,-162,69,38,1,29,10316,10316,10316,7.31667988,7.148712023,0.167967858,1.343742861,-1.088431718,0.255311144
50,3,5,37,137,North Carolina,Pamlico County,12276,12280,12344,4,64,18,80,55,200,-37,-120,0,-1,44,188,44,187,-3,-3,623,623,623,6.497725796,16.24431449,-9.746588694,-0.081221572,15.26965562,15.18843405
50,3,5,37,139,North Carolina,Pasquotank County,40568,40645,40821,77,176,127,441,133,517,-6,-76,5,6,78,247,83,253,0,-1,1960,1960,1960,10.82660251,12.69241156,-1.865809049,0.147300714,6.06387941,6.211180124
50,3,5,37,141,North Carolina,Pender County,60203,60563,62815,360,2252,132,601,193,739,-61,-138,0,0,420,2427,420,2427,1,-37,730,730,730,9.742417611,11.97944528,-2.237027671,0,39.34250839,39.34250839
50,3,5,37,143,North Carolina,Perquimans County,13005,12997,13130,-8,133,24,97,58,190,-34,-93,-1,0,30,226,29,226,-3,0,29,29,29,7.425268879,14.5443411,-7.119072224,0,17.300111,17.300111
50,3,5,37,145,North Carolina,Person County,39097,39146,39127,49,-19,97,410,137,529,-40,-119,0,5,92,88,92,93,-3,7,308,308,308,10.47615397,13.51679379,-3.040639812,0.127757975,2.248540365,2.37629834
50,3,5,37,147,North Carolina,Pitt County,170243,170570,172169,327,1599,490,1931,414,1780,76,151,0,33,246,1397,246,1430,5,18,5906,5906,5906,11.26804945,10.38691249,0.881136958,0.192566355,8.151975702,8.344542057
50,3,5,37,149,North Carolina,Polk County,19328,19372,19656,44,284,32,127,88,383,-56,-256,0,4,104,543,104,547,-4,-7,212,212,212,6.508147996,19.62693451,-13.11878651,0.204981039,27.82617608,28.03115712
50,3,5,37,151,North Carolina,Randolph County,144171,144334,145172,163,838,379,1492,521,1904,-142,-412,-4,-7,312,1252,308,1245,-3,5,1082,1082,1082,10.30721298,13.15344069,-2.846227712,-0.048358238,8.649216251,8.600858013
50,3,5,37,153,North Carolina,Richmond County,42946,42879,42724,-67,-155,155,573,175,668,-20,-95,0,-1,-47,-67,-47,-68,0,8,669,669,669,13.38738128,15.60692966,-2.21954838,-0.023363667,-1.5653657,-1.588729367
50,3,5,37,155,North Carolina,Robeson County,116530,116361,116328,-169,-33,408,1682,444,1761,-36,-79,0,31,-135,-8,-135,23,2,23,3368,3368,3368,14.45706501,15.13608293,-0.679017917,0.266450069,-0.068761308,0.197688761
50,3,5,37,157,North Carolina,Rockingham County,91096,91080,91266,-16,186,203,890,357,1450,-154,-560,-1,1,145,742,144,743,-6,3,891,891,891,9.761661896,15.90383118,-6.142169283,0.010968159,8.138374299,8.149342459
50,3,5,37,159,North Carolina,Rowan County,146875,147027,148150,152,1123,377,1519,505,1907,-128,-388,3,37,280,1467,283,1504,-3,7,4163,4163,4163,10.29212981,12.92106092,-2.628931116,0.250697039,9.939798833,10.19049587
50,3,5,37,161,North Carolina,Rutherford County,64444,64421,64586,-23,165,151,616,251,1024,-100,-408,0,5,82,567,82,572,-5,1,940,940,940,9.549869387,15.87510755,-6.325238165,0.077515174,8.790220686,8.867735859
50,3,5,37,163,North Carolina,Sampson County,59036,59021,58990,-15,-31,191,707,199,825,-8,-118,1,52,-6,24,-5,76,-2,11,613,613,613,11.98193389,13.98174746,-1.999813577,0.88127378,0.406741744,1.288015524
50,3,5,37,165,North Carolina,Scotland County,34174,34110,34227,-64,117,88,389,129,485,-41,-96,0,7,-23,204,-23,211,0,2,2330,2330,2330,11.38475496,14.1943603,-2.809605338,0.204867056,5.970411344,6.1752784
50,3,5,37,167,North Carolina,Stanly County,62504,62609,63425,105,816,138,633,219,875,-81,-242,0,0,189,1066,189,1066,-3,-8,1979,1979,1979,10.04490852,13.88514211,-3.840233588,0,16.91607027,16.91607027
50,3,5,37,169,North Carolina,Stokes County,44520,44517,44553,-3,36,86,369,158,685,-72,-316,1,5,74,343,75,348,-6,4,338,338,338,8.285618053,15.38116089,-7.095542831,0.112271247,7.701807567,7.814078814
50,3,5,37,171,North Carolina,Surry County,71359,71253,71152,-106,-101,187,745,331,1110,-144,-365,0,7,44,246,44,253,-6,11,709,709,709,10.46311576,15.58934026,-5.126224501,0.098311155,3.454934869,3.553246024
50,3,5,37,173,North Carolina,Swain County,14117,14083,14136,-34,53,34,156,55,257,-21,-101,0,3,-12,150,-12,153,-1,1,193,193,193,11.05638045,18.21467805,-7.158297601,0.212622701,10.63113505,10.84375775
50,3,5,37,175,North Carolina,Transylvania County,32986,33009,33165,23,156,54,229,128,518,-74,-289,0,3,103,447,103,450,-6,-5,829,829,829,6.921147278,15.65569559,-8.734548312,0.090670052,13.5098377,13.60050775
50,3,5,37,177,North Carolina,Tyrrell County,3245,3232,3254,-13,22,6,28,13,44,-7,-16,0,0,-5,38,-5,38,-1,0,299,299,299,8.633980882,13.56768424,-4.933703361,0,11.71754548,11.71754548
50,3,5,37,179,North Carolina,Union County,238267,239287,243648,1020,4361,556,2287,485,1962,71,325,0,61,942,4005,942,4066,7,-30,2562,2562,2562,9.471253896,8.125317072,1.345936824,0.252621989,16.58608301,16.838705
50,3,5,37,181,North Carolina,Vance County,42578,42529,42185,-49,-344,106,553,153,623,-47,-70,2,44,-2,-321,0,-277,-2,3,563,563,563,13.05569327,14.70831268,-1.652619402,1.038789338,-7.578440399,-6.539651061
50,3,5,37,183,North Carolina,Wake County,1129410,1133553,1150204,4143,16651,3074,12257,1873,7632,1201,4625,104,1390,2763,10518,2867,11908,75,118,20986,20986,20986,10.73406672,6.683723356,4.05034336,1.217292383,9.211137612,10.42843
50,3,5,37,185,North Carolina,Warren County,18642,18598,18762,-44,164,46,151,79,301,-33,-150,-1,1,-7,317,-8,318,-3,-4,736,736,736,8.083511777,16.11349036,-8.029978587,0.053533191,16.97002141,17.0235546
50,3,5,37,187,North Carolina,Washington County,11003,10955,10892,-48,-63,26,118,51,202,-25,-84,1,0,-23,20,-22,20,-1,1,72,72,72,10.8023985,18.4922415,-7.689842999,0,1.830915,1.830915
50,3,5,37,189,North Carolina,Watauga County,54086,54072,54234,-14,162,67,307,135,497,-68,-190,-1,12,56,332,55,344,-1,8,5424,5424,5424,5.669122671,9.17770022,-3.508577549,0.221594372,6.130777612,6.352371983
50,3,5,37,191,North Carolina,Wayne County,117333,117226,116835,-107,-391,353,1540,425,1657,-72,-117,8,81,-42,-373,-34,-292,-1,18,2459,2459,2459,13.15896283,14.15870222,-0.999739384,0.692127266,-3.187203336,-2.49507607
50,3,5,37,193,North Carolina,Wilkes County,65969,65871,65806,-98,-65,139,668,220,1050,-81,-382,-1,31,-9,277,-10,308,-7,9,747,747,747,10.14603917,15.94811546,-5.802076293,0.470849123,4.207264746,4.67811387
50,3,5,37,195,North Carolina,Wilson County,78784,78811,78369,27,-442,237,906,253,1123,-16,-217,1,25,46,-261,47,-236,-4,11,1221,1221,1221,11.52818425,14.28934979,-2.761165543,0.318106629,-3.32103321,-3.002926581
50,3,5,37,197,North Carolina,Yadkin County,37214,37182,37192,-32,10,82,365,141,543,-59,-178,0,0,30,185,30,185,-3,3,207,207,207,9.81525802,14.601877,-4.78661898,0,4.974856805,4.974856805
50,3,5,37,199,North Carolina,Yancey County,18470,18475,18757,5,282,49,167,68,271,-19,-104,0,1,27,388,27,389,-3,-3,133,133,133,8.970777826,14.55737,-5.586592179,0.053717233,20.84228621,20.89600344
40,2,4,38,0,North Dakota,North Dakota,779094,778962,774948,-132,-4014,2638,9798,2116,7588,522,2210,-3,294,-659,-6460,-662,-6166,8,-58,23791,23791,23791,12.61076896,9.766331383,2.84443758,0.378400294,-8.314509849,-7.936109556
50,2,4,38,1,North Dakota,Adams County,2200,2188,2167,-12,-21,6,23,8,23,-2,0,0,2,-9,-23,-9,-21,-1,0,38,38,38,10.56257176,10.56257176,0,0.918484501,-10.56257176,-9.644087256
50,2,4,38,3,North Dakota,Barnes County,10853,10836,10806,-17,-30,26,92,50,148,-24,-56,0,2,8,23,8,25,-1,1,528,528,528,8.501986877,13.67710932,-5.175122447,0.184825802,2.125496719,2.310322521
50,2,4,38,5,North Dakota,Benson County,5964,5953,5809,-11,-144,34,120,16,93,18,27,1,0,-30,-169,-29,-169,0,-2,3,3,3,20.40469308,15.81363714,4.591055943,0,-28.73660942,-28.73660942
50,2,4,38,7,North Dakota,Billings County,945,931,955,-14,24,1,7,2,6,-1,1,0,0,-13,23,-13,23,0,0,9,9,9,7.423117709,6.362672322,1.060445387,0,24.3902439,24.3902439
50,2,4,38,9,North Dakota,Bottineau County,6379,6377,6390,-2,13,15,59,20,85,-5,-26,0,1,4,39,4,40,-1,-1,202,202,202,9.242578523,13.31557923,-4.073000705,0.156653873,6.109501057,6.266154931
50,2,4,38,11,North Dakota,Bowman County,2993,2981,2903,-12,-78,8,37,8,43,0,-6,0,0,-13,-71,-13,-71,1,-1,45,45,45,12.57647859,14.61590755,-2.03942896,0,-24.13324269,-24.13324269
50,2,4,38,13,North Dakota,Burke County,2201,2189,2158,-12,-31,6,24,12,17,-6,7,0,0,-6,-37,-6,-37,0,-1,2,2,2,11.042098,7.821486082,3.220611916,0,-17.02323441,-17.02323441
50,2,4,38,15,North Dakota,Burleigh County,98458,98467,98933,9,466,296,1111,288,965,8,146,0,33,1,266,1,299,0,21,3821,3821,3821,11.25633232,9.77710233,1.47922999,0.334346505,2.695035461,3.029381966
50,2,4,38,17,North Dakota,Cass County,184525,184868,186562,343,1694,656,2278,374,1422,282,856,-5,127,56,676,51,803,10,35,5235,5235,5235,12.26610667,7.656893627,4.609213042,0.683843524,3.639986,4.323829524
50,2,4,38,19,North Dakota,Cavalier County,3704,3693,3662,-11,-31,11,39,14,53,-3,-14,0,0,-8,-17,-8,-17,0,0,58,58,58,10.60503059,14.41196465,-3.806934058,0,-4.622705642,-4.622705642
50,2,4,38,21,North Dakota,Dickey County,4999,4959,4897,-40,-62,14,60,22,81,-8,-21,0,0,-31,-41,-31,-41,-1,0,181,181,181,12.17532468,16.43668831,-4.261363636,0,-8.319805195,-8.319805195
50,2,4,38,23,North Dakota,Divide County,2195,2198,2188,3,-10,6,25,10,17,-4,8,0,-1,8,-17,8,-18,-1,0,39,39,39,11.3999088,7.751937985,3.647970816,-0.455996352,-7.751937984,-8.207934337
50,2,4,38,25,North Dakota,Dunn County,4095,4103,4035,8,-68,20,81,12,31,8,50,0,2,0,-119,0,-117,0,-1,77,77,77,19.90661096,7.618579504,12.28803146,0.491521258,-29.24551487,-28.75399361
50,2,4,38,27,North Dakota,Eddy County,2347,2333,2337,-14,4,10,21,10,37,0,-16,0,0,-13,20,-13,20,-1,0,66,66,66,8.993576017,15.84582441,-6.852248394,0,8.565310493,8.565310493
50,2,4,38,29,North Dakota,Emmons County,3301,3282,3271,-19,-11,6,36,18,49,-12,-13,0,0,-7,3,-7,3,0,-1,45,45,45,10.98733405,14.95498245,-3.967648405,0,0.915611171,0.915611171
50,2,4,38,31,North Dakota,Foster County,3397,3389,3364,-8,-25,15,35,11,48,4,-13,0,0,-12,-12,-12,-12,0,0,53,53,53,10.36576336,14.21590404,-3.850140678,0,-3.553976011,-3.553976011
50,2,4,38,33,North Dakota,Golden Valley County,1736,1730,1770,-6,40,5,17,2,14,3,3,0,0,-10,38,-10,38,1,-1,52,52,52,9.714285714,8,1.714285714,0,21.71428571,21.71428571
50,2,4,38,35,North Dakota,Grand Forks County,73170,73062,72705,-108,-357,228,861,176,572,52,289,-3,35,-160,-685,-163,-650,3,4,3038,3038,3038,11.8133734,7.848141212,3.965232186,0.480218431,-9.398560717,-8.918342286
50,2,4,38,37,North Dakota,Grant County,2301,2281,2323,-20,42,3,26,11,27,-8,-1,0,0,-11,44,-11,44,-1,-1,4,4,4,11.2945265,11.72893136,-0.434404865,0,19.11381408,19.11381408
50,2,4,38,39,North Dakota,Griggs County,2306,2296,2281,-10,-15,1,20,11,30,-10,-10,0,0,1,-5,1,-5,-1,0,35,35,35,8.739348919,13.10902338,-4.369674459,0,-2.18483723,-2.18483723
50,2,4,38,41,North Dakota,Hettinger County,2489,2474,2430,-15,-44,10,26,10,38,0,-12,0,0,-15,-32,-15,-32,0,0,128,128,128,10.60358891,15.49755302,-4.893964111,0,-13.05057096,-13.05057096
50,2,4,38,43,North Dakota,Kidder County,2394,2384,2369,-10,-15,4,30,6,23,-2,7,0,0,-9,-21,-9,-21,1,-1,0,0,0,12.62360614,9.678098043,2.9455081,0,-8.8365243,-8.8365243
50,2,4,38,45,North Dakota,LaMoure County,4093,4083,4066,-10,-17,14,38,17,45,-3,-7,0,0,-7,-10,-7,-10,0,0,51,51,51,9.326297705,11.04429991,-1.718002209,0,-2.45428887,-2.45428887
50,2,4,38,47,North Dakota,Logan County,1876,1885,1883,9,-2,9,21,5,21,4,0,0,0,6,-2,6,-2,-1,0,49,49,49,11.14649682,11.14649682,0,0,-1.061571125,-1.061571125
50,2,4,38,49,North Dakota,McHenry County,5345,5322,5249,-23,-73,18,49,26,80,-8,-31,0,0,-16,-41,-16,-41,1,-1,27,27,27,9.270646107,15.13574875,-5.865102639,0,-7.757071233,-7.757071233
50,2,4,38,51,North Dakota,McIntosh County,2530,2512,2513,-18,1,2,29,16,53,-14,-24,0,2,-4,25,-4,27,0,-2,88,88,88,11.54228856,21.09452736,-9.552238806,0.796019901,9.950248756,10.74626866
50,2,4,38,53,North Dakota,McKenzie County,14704,14744,13819,40,-925,67,253,29,104,38,149,0,-3,-1,-1049,-1,-1052,3,-22,102,102,102,17.71522599,7.282148234,10.43307776,-0.210061968,-73.45166824,-73.66173021
50,2,4,38,55,North Dakota,McLean County,9771,9749,9796,-22,47,21,97,36,121,-15,-24,0,0,-5,70,-5,70,-2,1,132,132,132,9.925812228,12.3816833,-2.455871067,0,7.162957278,7.162957278
50,2,4,38,57,North Dakota,Mercer County,8350,8330,8323,-20,-7,16,86,20,77,-4,9,0,0,-15,-18,-15,-18,-1,2,107,107,107,10.32846935,9.247583018,1.080886327,0,-2.161772654,-2.161772654
50,2,4,38,59,North Dakota,Morton County,33291,33333,33611,42,278,114,413,87,375,27,38,2,7,14,231,16,238,-1,2,778,778,778,12.33867113,11.20339388,1.135277247,0.209130019,6.901290631,7.11042065
50,2,4,38,61,North Dakota,Mountrail County,9809,9765,9576,-44,-189,37,169,51,83,-14,86,0,2,-31,-273,-31,-271,1,-4,417,417,417,17.47582855,8.582803371,8.89302518,0.206814539,-28.23018458,-28.02337004
50,2,4,38,63,North Dakota,Nelson County,3015,2989,3054,-26,65,5,23,18,46,-13,-23,0,5,-13,85,-13,90,0,-2,77,77,77,7.612113189,15.22422638,-7.612113189,1.654807215,28.13172265,29.78652987
50,2,4,38,65,North Dakota,Oliver County,1877,1866,1873,-11,7,5,16,5,12,0,4,0,0,-10,2,-10,2,-1,1,1,1,1,8.558438085,6.418828564,2.139609521,0,1.069804761,1.069804761
50,2,4,38,67,North Dakota,Pembina County,6844,6827,6767,-17,-60,21,71,20,98,1,-27,0,1,-17,-34,-17,-33,-1,0,133,133,133,10.44578491,14.41812564,-3.972340739,0.147123731,-5.002206856,-4.855083125
50,2,4,38,69,North Dakota,Pierce County,3990,3968,3953,-22,-15,13,29,18,57,-5,-28,0,1,-17,13,-17,14,0,-1,222,222,222,7.322307789,14.39212221,-7.069814417,0.252493372,3.282413837,3.534907209
50,2,4,38,71,North Dakota,Ramsey County,11605,11555,11572,-50,17,37,139,57,159,-20,-20,0,6,-29,30,-29,36,-1,1,380,380,380,12.020582,13.75016215,-1.729580144,0.518874043,2.594370217,3.11324426
50,2,4,38,73,North Dakota,Ransom County,5703,5703,5675,0,-28,16,43,16,89,0,-46,0,2,0,15,0,17,0,1,137,137,137,7.558446124,15.6442257,-8.085779575,0.351555634,2.636667253,2.988222886
50,2,4,38,75,North Dakota,Renville County,2282,2272,2266,-10,-6,5,14,6,27,-1,-13,0,0,-9,8,-9,8,0,-1,46,46,46,6.170118995,11.89951521,-5.72939621,0,3.525782283,3.525782283
50,2,4,38,77,North Dakota,Richland County,16529,16524,16560,-5,36,47,163,26,165,21,-2,0,-2,-26,38,-26,36,0,2,890,890,890,9.853705719,9.974610083,-0.120904365,-0.120904365,2.297182928,2.176278564
50,2,4,38,79,North Dakota,Rolette County,12187,12162,12048,-25,-114,49,218,45,199,4,19,0,1,-29,-134,-29,-133,0,0,49,49,49,18.00908715,16.43948782,1.569599339,0.082610492,-11.06980587,-10.98719537
50,2,4,38,81,North Dakota,Sargent County,3862,3842,3829,-20,-13,9,41,15,50,-6,-9,0,1,-13,-6,-13,-5,-1,1,23,23,23,10.68961022,13.03611003,-2.346499804,0.260722201,-1.564333203,-1.303611002
50,2,4,38,83,North Dakota,Sheridan County,1265,1258,1268,-7,10,3,12,3,17,0,-5,0,0,-6,15,-6,15,-1,0,1,1,1,9.501187649,13.46001584,-3.958828187,0,11.87648456,11.87648456
50,2,4,38,85,North Dakota,Sioux County,3898,3884,3738,-14,-146,20,59,15,72,5,-13,0,0,-19,-131,-19,-131,0,-2,20,20,20,15.48150092,18.89267909,-3.411178168,0,-34.37418001,-34.37418001
50,2,4,38,87,North Dakota,Slope County,706,701,690,-5,-11,0,6,3,2,-3,4,0,0,-2,-14,-2,-14,0,-1,0,0,0,8.626887132,2.875629044,5.751258088,0,-20.12940331,-20.12940331
50,2,4,38,89,North Dakota,Stark County,33646,33805,33046,159,-759,142,535,68,300,74,235,0,10,83,-988,83,-978,2,-16,529,529,529,16.00574412,8.975183617,7.0305605,0.299172787,-29.55827138,-29.25909859
50,2,4,38,91,North Dakota,Steele County,1798,1797,1810,-1,13,7,18,3,16,4,2,0,0,-4,11,-4,11,-1,0,0,0,0,9.980593291,8.871638481,1.10895481,0,6.099251456,6.099251456
50,2,4,38,93,North Dakota,Stutsman County,21593,21529,21576,-64,47,50,199,65,276,-15,-77,0,6,-48,117,-48,123,-1,1,1669,1669,1669,9.233267602,12.80593899,-3.572671384,0.278389978,5.42860457,5.706994548
50,2,4,38,95,North Dakota,Towner County,2162,2138,2140,-24,2,3,24,10,28,-7,-4,0,3,-16,4,-16,7,-1,-1,29,29,29,11.22019635,13.09022908,-1.870032726,1.402524544,1.870032726,3.27255727
50,2,4,38,97,North Dakota,Traill County,7997,7974,8003,-23,29,20,94,26,101,-6,-7,0,1,-16,34,-16,35,-1,1,265,265,265,11.76691494,12.64317456,-0.876259623,0.125179946,4.25611817,4.381298116
50,2,4,38,99,North Dakota,Walsh County,10563,10520,10469,-43,-51,27,102,35,129,-8,-27,-1,0,-33,-26,-34,-26,-1,2,296,296,296,9.719376816,12.29215303,-2.572776216,0,-2.477488208,-2.477488208
50,2,4,38,101,North Dakota,Ward County,69919,69847,69071,-72,-776,272,1008,197,669,75,339,1,26,-151,-1132,-150,-1106,3,-9,3125,3125,3125,14.51215825,9.631581221,4.880577031,0.374321542,-16.29738407,-15.92306253
50,2,4,38,103,North Dakota,Wells County,3982,3955,3905,-27,-50,5,43,18,54,-13,-11,0,0,-13,-39,-13,-39,-1,0,68,68,68,10.94147583,13.74045802,-2.798982188,0,-9.923664122,-9.923664122
50,2,4,38,105,North Dakota,Williams County,40950,41149,38484,199,-2665,203,758,69,241,134,517,2,24,57,-3144,59,-3120,6,-62,421,421,421,19.03733377,6.052767069,12.9845667,0.602765185,-78.96223927,-78.35947409
40,2,3,39,0,Ohio,Ohio,11799448,11790587,11780017,-8861,-10570,32291,128595,36827,144406,-4536,-15811,434,7084,-4487,-3128,-4053,3956,-272,1285,301360,301360,301360,10.91147261,12.25305894,-1.341586325,0.601087694,-0.265415345,0.335672349
50,2,3,39,1,Ohio,Adams County,27477,27434,27542,-43,108,82,321,105,408,-23,-87,0,0,-19,192,-19,192,-1,3,265,265,265,11.67782305,14.84284051,-3.165017462,0,6.984866123,6.984866123
50,2,3,39,3,Ohio,Allen County,102206,102059,101670,-147,-389,298,1166,314,1361,-16,-195,0,8,-129,-220,-129,-212,-2,18,5583,5583,5583,11.44657854,13.36088628,-1.914307732,0.078535702,-2.159731801,-2.081196099
50,2,3,39,5,Ohio,Ashland County,52447,52420,52316,-27,-104,134,571,171,701,-37,-130,0,11,13,6,13,17,-3,9,1878,1878,1878,10.90360526,13.38603728,-2.48243202,0.21005194,0.114573786,0.324625726
50,2,3,39,7,Ohio,Ashtabula County,97574,97413,97337,-161,-76,239,1031,340,1317,-101,-286,0,12,-55,182,-55,194,-5,16,3112,3112,3112,10.58793325,13.52503209,-2.937098845,0.123234917,1.869062901,1.992297818
50,2,3,39,9,Ohio,Athens County,62431,62350,62056,-81,-294,114,458,139,629,-25,-171,0,71,-58,-207,-58,-136,2,13,8994,8994,8994,7.362988923,10.11205247,-2.74906355,1.141424047,-3.327813771,-2.186389724
50,2,3,39,11,Ohio,Auglaize County,46422,46411,46141,-11,-270,131,504,159,617,-28,-113,0,1,19,-166,19,-165,-2,8,471,471,471,10.89117469,13.33304521,-2.441870516,0.021609474,-3.587172616,-3.565563143
50,2,3,39,13,Ohio,Belmont County,66497,66235,65849,-262,-386,157,601,279,994,-122,-393,0,1,-135,-4,-135,-3,-5,10,3451,3451,3451,9.100269526,15.05102813,-5.950758608,0.015141879,-0.060567518,-0.045425638
50,2,3,39,15,Ohio,Brown County,43676,43629,43662,-47,33,133,460,176,632,-43,-172,-1,2,-1,198,-2,200,-2,5,505,505,505,10.53945997,14.48030152,-3.940841553,0.045823739,4.53655016,4.582373899
50,2,3,39,17,Ohio,Butler County,390357,390600,390234,243,-366,1115,4299,1026,4387,89,-88,16,280,137,-624,153,-344,1,66,12152,12152,12152,11.0113033,11.23670332,-0.225400021,0.717181885,-1.598291058,-0.881109173
50,2,3,39,19,Ohio,Carroll County,26721,26689,26691,-32,2,61,268,86,393,-25,-125,0,0,-4,126,-4,126,-3,1,333,333,333,10.04121394,14.72461596,-4.683402023,0,4.720869239,4.720869239
50,2,3,39,21,Ohio,Champaign County,38714,38705,38699,-9,-6,111,377,136,517,-25,-140,0,1,19,127,19,128,-3,6,585,585,585,9.741098651,13.35848277,-3.617384115,0.025838458,3.281484161,3.307322619
50,2,3,39,23,Ohio,Clark County,136001,135719,135633,-282,-86,348,1548,543,2032,-195,-484,-1,33,-79,343,-80,376,-7,22,3210,3210,3210,11.40953448,14.97685663,-3.56732215,0.24322651,2.528081606,2.771308116
50,2,3,39,25,Ohio,Clermont County,208601,208635,209642,34,1007,553,2175,560,2333,-7,-158,1,74,44,1065,45,1139,-4,26,1592,1592,1592,10.39980683,11.15528705,-0.75548022,0.353832508,5.092319205,5.446151713
50,2,3,39,27,Ohio,Clinton County,42018,41962,42004,-56,42,113,467,158,553,-45,-86,4,16,-14,104,-10,120,-1,8,1045,1045,1045,11.12355001,13.17199819,-2.048448181,0.381106638,2.47719315,2.858299788
50,2,3,39,29,Ohio,Columbiana County,101877,101607,101310,-270,-297,221,985,395,1475,-174,-490,1,18,-91,160,-90,178,-6,15,3854,3854,3854,9.708402943,14.5379638,-4.829560855,0.17741244,1.576999463,1.754411902
50,2,3,39,31,Ohio,Coshocton County,36612,36548,36618,-64,70,94,447,128,482,-34,-35,1,1,-28,98,-27,99,-3,6,362,362,362,12.21879015,13.17551868,-0.956728535,0.027335101,2.678839898,2.706174999
50,2,3,39,33,Ohio,Crawford County,42025,41928,41754,-97,-174,98,432,193,617,-95,-185,0,8,2,-4,2,4,-4,7,528,528,528,10.32480103,14.74630148,-4.421500442,0.191200019,-0.09560001,0.09560001
50,2,3,39,35,Ohio,Cuyahoga County,1264817,1261696,1249387,-3121,-12309,3267,13253,4200,16137,-933,-2884,84,869,-2230,-10359,-2146,-9490,-42,65,29995,29995,29995,10.55560489,12.85262176,-2.297016865,0.692131642,-8.250623337,-7.558491695
50,2,3,39,37,Ohio,Darke County,51881,51882,51597,1,-285,176,567,186,711,-10,-144,0,5,14,-153,14,-148,-3,7,549,549,549,10.95874525,13.74191865,-2.783173398,0.096637965,-2.957121735,-2.86048377
50,2,3,39,39,Ohio,Defiance County,38286,38227,38144,-59,-83,114,397,126,481,-12,-84,0,22,-45,-23,-45,-1,-2,2,674,674,674,10.39661652,12.59640439,-2.199787878,0.57613492,-0.602322871,-0.026187951
50,2,3,39,41,Ohio,Delaware County,214124,215062,220740,938,5678,513,2065,372,1654,141,411,2,129,788,5194,790,5323,7,-56,1767,1767,1767,9.47678074,7.590603072,1.886177668,0.592011969,23.83651291,24.42852488
50,2,3,39,43,Ohio,Erie County,75622,75429,74852,-193,-577,194,709,320,1151,-126,-442,-1,4,-59,-148,-60,-144,-7,9,1607,1607,1607,9.435657202,15.317971,-5.882313799,0.053233609,-1.969643534,-1.916409925
50,2,3,39,45,Ohio,Fairfield County,158921,159357,161064,436,1707,389,1715,434,1746,-45,-31,3,73,479,1669,482,1742,-1,-4,2535,2535,2535,10.70466667,10.89816211,-0.193495433,0.455650535,10.41754442,10.87319495
50,2,3,39,47,Ohio,Fayette County,28951,28939,28906,-12,-33,84,299,121,362,-37,-63,0,6,26,22,26,28,-1,2,543,543,543,10.33797217,12.51620711,-2.178234938,0.207450947,0.760653471,0.968104417
50,2,3,39,49,Ohio,Franklin County,1323807,1324013,1321414,206,-2599,4491,17346,3091,12442,1400,4904,182,2166,-1431,-9799,-1249,-7633,55,130,30222,30222,30222,13.11395098,9.406420967,3.707530013,1.637542824,-7.408255832,-5.770713008
50,2,3,39,51,Ohio,Fulton County,42713,42619,42450,-94,-169,111,449,118,508,-7,-59,0,22,-86,-137,-86,-115,-1,5,347,347,347,10.55613678,11.94324607,-1.387109288,0.517227192,-3.220914787,-2.703687595
50,2,3,39,53,Ohio,Gallia County,29220,29193,29158,-27,-35,90,367,106,455,-16,-88,-2,10,-8,37,-10,47,-1,6,769,769,769,12.57904749,15.59527686,-3.016229371,0.342753338,1.268187349,1.610940687
50,2,3,39,55,Ohio,Geauga County,95397,95334,95565,-63,231,247,890,243,1036,4,-146,0,38,-60,335,-60,373,-7,4,813,813,813,9.32430238,10.85390704,-1.52960466,0.398116281,3.509709323,3.907825604
50,2,3,39,57,Ohio,Greene County,167966,168025,168412,59,387,411,1616,439,1900,-28,-284,2,137,91,507,93,644,-6,27,8069,8069,8069,9.606553382,11.2948338,-1.688280421,0.814416964,3.01393723,3.828354194
50,2,3,39,59,Ohio,Guernsey County,38438,38390,38287,-48,-103,93,437,133,543,-40,-106,0,3,-7,-6,-7,-3,-1,6,418,418,418,11.39846369,14.16330842,-2.764844738,0.078250323,-0.156500646,-0.078250323
50,2,3,39,61,Ohio,Hamilton County,830639,829909,826139,-730,-3770,2568,10318,2371,9691,197,627,58,778,-988,-5268,-930,-4490,3,93,23348,23348,23348,12.46099147,11.70376704,0.757224428,0.939586292,-6.362134431,-5.422548139
50,2,3,39,63,Ohio,Hancock County,74920,74830,74656,-90,-174,198,832,218,884,-20,-52,2,46,-70,-181,-68,-135,-2,13,1208,1208,1208,11.1314772,11.82719452,-0.695717325,0.615442249,-2.421631457,-1.806189208
50,2,3,39,65,Ohio,Hardin County,30696,30725,30621,29,-104,95,386,90,396,5,-10,0,6,25,-105,25,-99,-1,5,1730,1730,1730,12.58435758,12.91037721,-0.326019626,0.195611776,-3.423206077,-3.227594301
50,2,3,39,67,Ohio,Harrison County,14483,14493,14477,10,-16,54,154,51,237,3,-83,0,1,8,67,8,68,-1,-1,155,155,155,10.63168795,16.36175354,-5.730065585,0.069036935,4.625474629,4.694511564
50,2,3,39,69,Ohio,Henry County,27662,27629,27538,-33,-91,70,300,85,355,-15,-55,0,0,-15,-43,-15,-43,-3,7,315,315,315,10.87606721,12.87001287,-1.993945656,0,-1.558902967,-1.558902967
50,2,3,39,71,Ohio,Highland County,43317,43321,43354,4,33,120,495,154,611,-34,-116,0,4,39,140,39,144,-1,5,401,401,401,11.42197866,14.09864436,-2.676665705,0.092298817,3.23045861,3.322757427
50,2,3,39,73,Ohio,Hocking County,28050,27999,28097,-51,98,73,286,101,393,-28,-107,0,0,-21,203,-21,203,-2,2,251,251,251,10.19680548,14.01169424,-3.814888762,0,7.237592698,7.237592698
50,2,3,39,75,Ohio,Holmes County,44223,44194,44271,-29,77,201,792,111,446,90,346,0,1,-122,-275,-122,-274,3,5,697,697,697,17.90538631,10.08308371,7.822302606,0.022607811,-6.217148025,-6.194540214
50,2,3,39,77,Ohio,Huron County,58565,58439,58367,-126,-72,156,653,197,755,-41,-102,0,-2,-84,20,-84,18,-1,12,506,506,506,11.18093249,12.92741811,-1.746485626,-0.034244816,0.342448162,0.308203346
50,2,3,39,79,Ohio,Jackson County,32653,32642,32511,-11,-131,84,367,132,469,-48,-102,0,6,37,-41,37,-35,0,6,272,272,272,11.26578976,14.39688119,-3.131091431,0.184181849,-1.258575967,-1.074394118
50,2,3,39,81,Ohio,Jefferson County,65249,65107,64789,-142,-318,173,633,279,1031,-106,-398,0,6,-31,63,-31,69,-5,11,2260,2260,2260,9.746258545,15.87423785,-6.127979307,0.092381598,0.970006775,1.062388372
50,2,3,39,83,Ohio,Knox County,62721,62765,62897,44,132,188,657,180,800,8,-143,0,2,39,263,39,265,-3,10,3489,3489,3489,10.45662173,12.73256832,-2.275946587,0.031831421,4.185831835,4.217663255
50,2,3,39,85,Ohio,Lake County,232603,232410,232023,-193,-387,518,2048,748,2993,-230,-945,10,78,44,439,54,517,-17,41,2676,2676,2676,8.819356075,12.88883434,-4.069478267,0.335893444,1.890477206,2.22637065
50,2,3,39,87,Ohio,Lawrence County,58240,58132,57445,-108,-687,157,622,201,938,-44,-316,0,3,-62,-379,-62,-376,-2,5,559,559,559,10.76338718,16.23160317,-5.468215995,0.051913443,-6.558398297,-6.506484854
50,2,3,39,89,Ohio,Licking County,178519,178680,180401,161,1721,495,1843,512,2009,-17,-166,-1,39,183,1843,182,1882,-4,5,3375,3375,3375,10.26509339,11.18967587,-0.924582476,0.217221184,10.26509339,10.48231458
50,2,3,39,91,Ohio,Logan County,46150,46065,46035,-85,-30,105,496,115,621,-10,-125,-1,9,-72,78,-73,87,-2,8,403,403,403,10.77090119,13.48534202,-2.714440825,0.195439739,1.693811075,1.889250814
50,2,3,39,93,Ohio,Lorain County,312964,313367,315595,403,2228,827,3157,881,3749,-54,-592,1,145,470,2662,471,2807,-14,13,8218,8218,8218,10.03876228,11.92122895,-1.882466667,0.46107714,8.464740318,8.925817458
50,2,3,39,95,Ohio,Lucas County,431279,430728,429191,-551,-1537,1257,5112,1403,5613,-146,-501,5,190,-406,-1302,-401,-1112,-4,76,9193,9193,9193,11.88949192,13.05471794,-1.165226027,0.441902086,-3.02819219,-2.586290104
50,2,3,39,97,Ohio,Madison County,43824,43823,44386,-1,563,116,440,115,480,1,-40,0,9,-2,597,-2,606,0,-3,4454,4454,4454,9.976306273,10.88324321,-0.906936934,0.20406081,13.53603374,13.74009455
50,2,3,39,99,Ohio,Mahoning County,228614,227948,226762,-666,-1186,580,2311,981,3632,-401,-1321,2,62,-249,29,-247,91,-18,44,8804,8804,8804,10.16472037,15.97501704,-5.810296673,0.272701282,0.127553826,0.400255108
50,2,3,39,101,Ohio,Marion County,65359,65363,65291,4,-72,172,698,212,835,-40,-137,0,14,47,39,47,53,-3,12,5492,5492,5492,10.68470923,12.7818513,-2.09714207,0.214306489,0.596996648,0.811303137
50,2,3,39,103,Ohio,Medina County,182470,182550,183092,80,542,405,1576,477,1936,-72,-360,4,47,157,834,161,881,-9,21,1105,1105,1105,8.620453887,10.5895931,-1.969139213,0.257082064,4.561839176,4.81892124
50,2,3,39,105,Ohio,Meigs County,22210,22118,22049,-92,-69,42,183,107,337,-65,-154,0,4,-26,80,-26,84,-1,1,151,151,151,8.286729912,15.26026219,-6.973532275,0.181130708,3.622614169,3.803744877
50,2,3,39,107,Ohio,Mercer County,42528,42471,42309,-57,-162,147,622,140,504,7,118,0,12,-62,-295,-62,-283,-2,3,406,406,406,14.673272,11.8895966,2.783675395,0.283085633,-6.959188488,-6.676102854
50,2,3,39,109,Ohio,Miami County,108774,108821,109264,47,443,296,1156,355,1345,-59,-189,0,22,111,600,111,622,-5,10,979,979,979,10.60137103,12.33464016,-1.733269138,0.201756196,5.502441709,5.704197905
50,2,3,39,111,Ohio,Monroe County,13385,13354,13329,-31,-25,34,134,51,209,-17,-75,0,0,-13,49,-13,49,-1,1,116,116,116,10.04384814,15.66540494,-5.621556796,0,3.67275044,3.67275044
50,2,3,39,113,Ohio,Montgomery County,537309,536629,535840,-680,-789,1480,6216,1901,7334,-421,-1118,21,470,-263,-247,-242,223,-17,106,15046,15046,15046,11.59194345,13.6768522,-2.084908748,0.876482211,-0.460619375,0.415862836
50,2,3,39,115,Ohio,Morgan County,13802,13741,13682,-61,-59,37,132,61,211,-24,-79,0,0,-36,17,-36,17,-1,3,128,128,128,9.626955475,15.38854246,-5.761586989,0,1.239835175,1.239835175
50,2,3,39,117,Ohio,Morrow County,34950,34964,35151,14,187,96,355,93,401,3,-46,0,0,12,231,12,231,-1,2,277,277,277,10.12622121,11.43835128,-1.312130072,0,6.589174927,6.589174927
50,2,3,39,119,Ohio,Muskingum County,86410,86342,86408,-68,66,226,964,297,1145,-71,-181,0,11,6,221,6,232,-3,15,1471,1471,1471,11.16063676,13.25615051,-2.095513748,0.127351664,2.558610709,2.685962373
50,2,3,39,121,Ohio,Noble County,14115,14090,14176,-25,86,37,142,48,178,-11,-36,0,1,-11,121,-11,122,-3,0,2593,2593,2593,10.04740678,12.59463667,-2.547229887,0.070756386,8.561522677,8.632279063
50,2,3,39,123,Ohio,Ottawa County,40364,40260,40104,-104,-156,89,300,176,628,-87,-328,0,7,-12,166,-12,173,-5,-1,421,421,421,7.466029566,15.62888856,-8.162858992,0.174207357,4.131203026,4.305410383
50,2,3,39,125,Ohio,Paulding County,18806,18804,18871,-2,67,59,225,54,248,5,-23,0,1,-6,87,-6,88,-1,2,69,69,69,11.94426012,13.16522893,-1.220968812,0.053085601,4.618447246,4.671532847
50,2,3,39,127,Ohio,Perry County,35408,35439,35460,31,21,111,405,99,465,12,-60,0,8,19,69,19,77,0,4,236,236,236,11.42470275,13.1172513,-1.692548555,0.225673141,1.946430838,2.172103979
50,2,3,39,129,Ohio,Pickaway County,58539,58628,59333,89,705,172,595,201,693,-29,-98,1,10,116,798,117,808,1,-5,4369,4369,4369,10.08807996,11.74964607,-1.661566111,0.169547562,13.52989547,13.69944304
50,2,3,39,131,Ohio,Pike County,27088,27050,27089,-38,39,85,355,113,414,-28,-59,0,0,-10,95,-10,95,0,3,396,396,396,13.11439074,15.29396553,-2.179574798,0,3.509484845,3.509484845
50,2,3,39,133,Ohio,Portage County,161791,161775,162382,-16,607,330,1328,439,1727,-109,-399,9,143,89,843,98,986,-5,20,6959,6959,6959,8.193560528,10.6553306,-2.461770068,0.882288521,5.201183377,6.083471898
50,2,3,39,135,Ohio,Preble County,40999,40964,40867,-35,-97,104,396,148,557,-44,-161,0,3,11,56,11,59,-2,5,326,326,326,9.678483704,13.61342279,-3.934939082,0.073321846,1.368674463,1.44199631
50,2,3,39,137,Ohio,Putnam County,34451,34380,34318,-71,-62,95,399,94,392,1,7,0,11,-73,-84,-73,-73,1,4,271,271,271,11.61605869,11.41226819,0.203790503,0.32024222,-2.44548604,-2.125243821
50,2,3,39,139,Ohio,Richland County,124936,124840,125195,-96,355,314,1358,424,1720,-110,-362,-1,13,23,692,22,705,-8,12,6996,6996,6996,10.86247925,13.75807387,-2.895594617,0.103985442,5.535225069,5.639210511
50,2,3,39,141,Ohio,Ross County,77093,76985,76891,-108,-94,187,738,301,1059,-114,-321,0,3,9,210,9,213,-3,14,5269,5269,5269,9.592139125,13.76432972,-4.172190595,0.038992436,2.729470483,2.768462918
50,2,3,39,143,Ohio,Sandusky County,58896,58832,58715,-64,-117,159,596,184,777,-25,-181,0,28,-37,27,-37,55,-2,9,824,824,824,10.1406246,13.22024382,-3.079619216,0.476405183,0.459390712,0.935795894
50,2,3,39,145,Ohio,Scioto County,74008,73720,73346,-288,-374,152,775,366,1151,-214,-376,0,1,-72,-11,-72,-10,-2,12,2987,2987,2987,10.53948567,15.65283614,-5.113350468,0.013599336,-0.1495927,-0.135993364
50,2,3,39,147,Ohio,Seneca County,55069,54990,54906,-79,-84,143,570,197,683,-54,-113,-1,15,-22,5,-23,20,-2,9,2366,2366,2366,10.37344398,12.42993376,-2.056489772,0.272985368,0.090995123,0.363980491
50,2,3,39,149,Ohio,Shelby County,48230,48119,47977,-111,-142,179,567,184,585,-5,-18,0,10,-106,-141,-106,-131,0,7,493,493,493,11.8006993,12.17532468,-0.374625375,0.208125208,-2.934565435,-2.726440226
50,2,3,39,151,Ohio,Stark County,374853,374357,373834,-496,-523,1040,3801,1356,5088,-316,-1287,2,52,-160,651,-158,703,-22,61,8585,8585,8585,10.16050714,13.60080514,-3.440297999,0.139001939,1.740197356,1.879199295
50,2,3,39,153,Ohio,Summit County,540428,539530,537633,-898,-1897,1346,5555,1793,6996,-447,-1441,22,383,-454,-941,-432,-558,-19,102,9191,9191,9191,10.31413073,12.98967751,-2.675546784,0.711127285,-1.747182181,-1.036054896
50,2,3,39,155,Ohio,Trumbull County,201977,201405,201335,-572,-70,452,2020,823,3040,-371,-1020,0,10,-186,928,-186,938,-15,12,3708,3708,3708,10.03128569,15.09658837,-5.065302677,0.04965983,4.608432239,4.658092069
50,2,3,39,157,Ohio,Tuscarawas County,93263,93063,92500,-200,-563,260,1079,382,1266,-122,-187,-1,29,-72,-415,-73,-386,-5,10,1170,1170,1170,11.62947355,13.64496155,-2.015488001,0.31256231,-4.472874442,-4.160312131
50,2,3,39,159,Ohio,Union County,62784,63077,64971,293,1894,186,683,130,483,56,200,0,29,233,1682,233,1711,4,-17,2482,2482,2482,10.66787455,7.544045983,3.123828564,0.452955142,26.27139823,26.72435337
50,2,3,39,161,Ohio,Van Wert County,28931,28878,28732,-53,-146,74,326,101,378,-27,-52,2,3,-27,-100,-25,-97,-1,3,364,364,364,11.3174796,13.12272175,-1.805242145,0.104148585,-3.471619511,-3.367470925
50,2,3,39,163,Ohio,Vinton County,12800,12784,12696,-16,-88,30,116,47,185,-17,-69,0,0,1,-21,1,-21,0,2,37,37,37,9.105180534,14.52119309,-5.416012559,0,-1.648351648,-1.648351648
50,2,3,39,165,Ohio,Warren County,242337,243004,246553,667,3549,596,2359,620,2394,-24,-35,8,209,680,3388,688,3597,3,-13,5210,5210,5210,9.63728432,9.780270735,-0.142986414,0.853833159,13.8410849,14.69491806
50,2,3,39,167,Ohio,Washington County,59771,59613,59423,-158,-190,140,571,225,844,-85,-273,-1,11,-68,63,-69,74,-4,9,1503,1503,1503,9.593736349,14.18058403,-4.586847676,0.184818038,1.05850331,1.243321348
50,2,3,39,169,Ohio,Wayne County,116894,116840,116710,-54,-130,363,1356,376,1386,-13,-30,-1,30,-37,-150,-38,-120,-3,20,3288,3288,3288,11.6120745,11.86897881,-0.256904303,0.256904303,-1.284521516,-1.027617213
50,2,3,39,171,Ohio,Williams County,37102,37025,36716,-77,-309,90,395,109,448,-19,-53,1,11,-58,-268,-57,-257,-1,1,934,934,934,10.71317178,12.15063533,-1.437463555,0.298341493,-7.268683636,-6.970342143
50,2,3,39,173,Ohio,Wood County,132248,132212,132472,-36,260,299,1201,342,1388,-43,-187,2,79,6,344,8,423,-1,24,6392,6392,6392,9.07497242,10.48797812,-1.413005697,0.596938236,2.599325989,3.196264225
50,2,3,39,175,Ohio,Wyandot County,21900,21854,21708,-46,-146,47,226,79,299,-32,-73,0,0,-12,-76,-12,-76,-2,3,208,208,208,10.37601579,13.72756072,-3.351544924,0,-3.489279647,-3.489279647
40,3,7,40,0,Oklahoma,Oklahoma,3959353,3962031,3986639,2678,24608,11611,47125,11925,48995,-314,-1870,80,1523,2902,24687,2982,26210,10,268,101889,101889,101889,11.85732959,12.32784856,-0.470518967,0.383208763,6.211605212,6.594813975
50,3,7,40,1,Oklahoma,Adair County,19495,19415,19414,-80,-1,49,288,67,332,-18,-44,0,1,-61,36,-61,37,-1,6,30,30,30,14.83427335,17.10062067,-2.266347318,0.051507894,1.854284169,1.905792063
50,3,7,40,3,Oklahoma,Alfalfa County,5699,5713,5710,14,-3,15,53,15,65,0,-12,0,1,14,7,14,8,0,1,1029,1029,1029,9.279523768,11.38054802,-2.101024249,0.175085354,1.225597479,1.400682833
50,3,7,40,5,Oklahoma,Atoka County,14143,14174,14324,31,150,38,147,47,168,-9,-21,0,1,42,169,42,170,-2,1,731,731,731,10.31651344,11.79030107,-1.473787634,0.070180364,11.86048144,11.9306618
50,3,7,40,7,Oklahoma,Beaver County,5049,5012,4980,-37,-32,12,48,24,66,-12,-18,0,12,-25,-28,-25,-16,0,2,24,24,24,9.607686149,13.21056846,-3.602882306,2.401921537,-5.604483587,-3.20256205
50,3,7,40,9,Oklahoma,Beckham County,22410,22302,22046,-108,-256,56,290,66,289,-10,1,0,-3,-99,-252,-99,-255,1,-2,1931,1931,1931,13.07838009,13.03328222,0.045097862,-0.135293587,-11.36466132,-11.4999549
50,3,7,40,11,Oklahoma,Blaine County,8735,8711,8562,-24,-149,30,109,43,138,-13,-29,0,21,-11,-140,-11,-119,0,-1,64,64,64,12.62085336,15.97869507,-3.357841718,2.431540555,-16.21027036,-13.77872981
50,3,7,40,13,Oklahoma,Bryan County,46067,46293,47105,226,812,136,585,125,699,11,-114,0,12,215,920,215,932,0,-6,877,877,877,12.52703484,14.9682006,-2.441165764,0.256964817,19.70063599,19.95760081
50,3,7,40,15,Oklahoma,Caddo County,26945,26858,26368,-87,-490,87,310,110,461,-23,-151,0,25,-63,-361,-63,-336,-1,-3,1626,1626,1626,11.64844249,17.32236125,-5.673918762,0.939390523,-13.56479916,-12.62540863
50,3,7,40,17,Oklahoma,Canadian County,154405,155507,161737,1102,6230,421,1699,317,1421,104,278,0,31,988,6004,988,6035,10,-83,2399,2399,2399,10.71099847,8.958404257,1.752594218,0.195433168,37.85099167,38.04642483
50,3,7,40,19,Oklahoma,Carter County,48003,48003,48291,0,288,159,607,167,719,-8,-112,0,22,9,374,9,396,-1,4,779,779,779,12.60722371,14.93343303,-2.326209317,0.456933973,7.767877542,8.224811515
50,3,7,40,21,Oklahoma,Cherokee County,47078,47081,47627,3,546,137,541,161,598,-24,-57,-1,16,30,584,29,600,-2,3,1703,1703,1703,11.42458926,12.62828906,-1.203699793,0.337880644,12.33264349,12.67052414
50,3,7,40,23,Oklahoma,Choctaw County,14204,14196,14307,-8,111,40,153,58,241,-18,-88,0,0,10,201,10,201,0,-2,102,102,102,10.73571203,16.91050065,-6.174788619,0,14.10377855,14.10377855
50,3,7,40,25,Oklahoma,Cimarron County,2296,2290,2248,-6,-42,3,20,5,21,-2,-1,0,0,-4,-40,-4,-40,0,-1,6,6,6,8.814455707,9.255178493,-0.440722785,0,-17.62891141,-17.62891141
50,3,7,40,27,Oklahoma,Cleveland County,295528,296019,297597,491,1578,675,2739,677,2661,-2,78,4,108,482,1336,486,1444,7,56,10715,10715,10715,9.22818792,8.965391768,0.262796151,0.363871594,4.501226382,4.865097976
50,3,7,40,29,Oklahoma,Coal County,5266,5279,5276,13,-3,15,59,22,114,-7,-55,0,0,21,52,21,52,-1,0,25,25,25,11.17953577,21.6011369,-10.42160114,0,9.853150166,9.853150166
50,3,7,40,31,Oklahoma,Comanche County,121125,121129,122063,4,934,441,1630,292,1316,149,314,18,17,-168,585,-150,602,5,18,10020,10020,10020,13.40504622,10.82272443,2.582321787,0.139807231,4.81101352,4.950820751
50,3,7,40,33,Oklahoma,Cotton County,5527,5543,5480,16,-63,19,46,21,86,-2,-40,0,0,18,-24,18,-24,0,1,26,26,26,8.346185249,15.60373764,-7.25755239,0,-4.354531434,-4.354531434
50,3,7,40,35,Oklahoma,Craig County,14107,14146,14115,39,-31,48,129,52,281,-4,-152,0,1,43,120,43,121,0,0,970,970,970,9.129188635,19.88606206,-10.75687343,0.070768904,8.492268497,8.563037401
50,3,7,40,37,Oklahoma,Creek County,71754,71776,72029,22,253,200,818,253,1133,-53,-315,-1,7,78,556,77,563,-2,5,953,953,953,11.37651681,15.75744932,-4.380932513,0.097354056,7.732693578,7.830047634
50,3,7,40,39,Oklahoma,Custer County,28513,28423,28163,-90,-260,106,347,102,365,4,-18,0,-3,-96,-241,-96,-244,2,2,1408,1408,1408,12.26451773,12.90071749,-0.636199767,-0.106033294,-8.518007988,-8.624041282
50,3,7,40,41,Oklahoma,Delaware County,40397,40400,41000,3,600,107,410,180,719,-73,-309,0,2,81,918,81,920,-5,-11,204,204,204,10.07371007,17.66584767,-7.592137592,0.049140049,22.55528256,22.6044226
50,3,7,40,43,Oklahoma,Dewey County,4484,4466,4417,-18,-49,17,63,20,75,-3,-12,0,4,-15,-40,-15,-36,0,-1,54,54,54,14.18439716,16.8861871,-2.701789936,0.900596645,-9.005966453,-8.105369807
50,3,7,40,45,Oklahoma,Ellis County,3749,3745,3762,-4,17,12,53,7,55,5,-2,0,2,-9,18,-9,20,0,-1,32,32,32,14.12015452,14.65299054,-0.53283602,0.53283602,4.795524177,5.328360197
50,3,7,40,47,Oklahoma,Garfield County,62846,62629,61926,-217,-703,178,798,204,811,-26,-13,3,65,-194,-756,-191,-691,0,1,1767,1767,1767,12.81361648,13.0223596,-0.208743126,1.043715628,-12.13921561,-11.09549998
50,3,7,40,49,Oklahoma,Garvin County,25656,25627,25804,-29,177,71,347,103,410,-32,-63,0,5,4,236,4,241,-1,-1,189,189,189,13.49380724,15.94369155,-2.449884311,0.194435263,9.177344403,9.371779666
50,3,7,40,51,Oklahoma,Grady County,54795,54805,55508,10,703,135,518,163,713,-28,-195,0,7,39,900,39,907,-1,-9,934,934,934,9.391458849,12.92685359,-3.53539474,0.126911606,16.31720649,16.4441181
50,3,7,40,53,Oklahoma,Grant County,4169,4168,4131,-1,-37,9,33,20,76,-11,-43,0,0,10,6,10,6,0,0,36,36,36,7.952765393,18.31545969,-10.3626943,0,1.445957344,1.445957344
50,3,7,40,55,Oklahoma,Greer County,5491,5488,5487,-3,-1,10,50,16,77,-6,-27,0,0,4,25,4,25,-1,1,1046,1046,1046,9.111617312,14.03189066,-4.920273349,0,4.555808656,4.555808656
50,3,7,40,57,Oklahoma,Harmon County,2488,2465,2418,-23,-47,6,33,9,38,-3,-5,0,1,-20,-42,-20,-41,0,-1,74,74,74,13.51628098,15.56420234,-2.04792136,0.409584272,-17.20253942,-16.79295515
50,3,7,40,59,Oklahoma,Harper County,3272,3255,3180,-17,-75,8,33,10,60,-2,-27,0,4,-16,-50,-16,-46,1,-2,21,21,21,10.25641026,18.64801865,-8.391608392,1.243201243,-15.54001554,-14.2968143
50,3,7,40,61,Oklahoma,Haskell County,11561,11549,11602,-12,53,37,138,49,192,-12,-54,0,3,0,104,0,107,0,0,35,35,35,11.92173124,16.58675651,-4.665025269,0.259168071,8.98449311,9.243661181
50,3,7,40,63,Oklahoma,Hughes County,13367,13334,13405,-33,71,38,153,48,210,-10,-57,0,1,-23,127,-23,128,0,0,1528,1528,1528,11.44395826,15.7073937,-4.263435431,0.074797113,9.49923333,9.574030442
50,3,7,40,65,Oklahoma,Jackson County,24785,24731,24777,-54,46,90,337,71,267,19,70,-1,9,-73,-39,-74,-30,1,6,651,651,651,13.61396138,10.78613557,2.827825806,0.363577604,-1.575502949,-1.211925345
50,3,7,40,67,Oklahoma,Jefferson County,5337,5326,5438,-11,112,13,67,21,83,-8,-16,0,0,-3,130,-3,130,0,-2,77,77,77,12.44890375,15.42177629,-2.972872538,0,24.15458937,24.15458937
50,3,7,40,69,Oklahoma,Johnston County,10272,10222,10301,-50,79,33,127,42,189,-9,-62,0,0,-41,142,-41,142,0,-1,194,194,194,12.37635823,18.41835989,-6.042001657,0,13.83813283,13.83813283
50,3,7,40,71,Oklahoma,Kay County,43700,43541,43732,-159,191,119,522,190,648,-71,-126,0,3,-85,310,-85,313,-3,4,1200,1200,1200,11.96246262,14.84995359,-2.887490977,0.068749785,7.104144466,7.172894251
50,3,7,40,73,Oklahoma,Kingfisher County,15184,15151,15204,-33,53,49,165,43,171,6,-6,1,16,-40,41,-39,57,0,2,87,87,87,10.87135563,11.26667765,-0.395322023,1.054192061,2.701367155,3.755559216
50,3,7,40,75,Oklahoma,Kiowa County,8509,8487,8410,-22,-77,20,96,45,146,-25,-50,0,0,4,-28,4,-28,-1,1,127,127,127,11.36296384,17.28117417,-5.918210333,0,-3.314197787,-3.314197787
50,3,7,40,77,Oklahoma,Latimer County,9444,9461,9427,17,-34,26,95,29,153,-3,-58,0,1,21,21,21,22,-1,2,439,439,439,10.05929691,16.20076239,-6.141465481,0.105887336,2.223634053,2.329521389
50,3,7,40,79,Oklahoma,Le Flore County,48129,48131,48476,2,345,134,585,189,837,-55,-252,1,10,58,589,59,599,-2,-2,1354,1354,1354,12.11092364,17.3279369,-5.21701326,0.207024336,12.19373337,12.40075771
50,3,7,40,81,Oklahoma,Lincoln County,33458,33469,33829,11,360,76,354,94,449,-18,-95,0,2,30,456,30,458,-1,-3,250,250,250,10.52037208,13.34363577,-2.823263693,0.05943713,13.55166573,13.61110286
50,3,7,40,83,Oklahoma,Logan County,49555,49726,50885,171,1159,128,479,117,467,11,12,0,13,160,1146,160,1159,0,-12,2139,2139,2139,9.52182167,9.283279164,0.238542505,0.258421047,22.78080926,23.0392303
50,3,7,40,85,Oklahoma,Love County,10146,10143,10216,-3,73,25,109,45,138,-20,-29,1,2,15,100,16,102,1,0,67,67,67,10.70779508,13.55665799,-2.848862911,0.196473304,9.82366521,10.02013851
50,3,7,40,87,Oklahoma,McClain County,41662,41887,43516,225,1629,97,427,97,435,0,-8,0,3,223,1659,223,1662,2,-25,155,155,155,9.999648724,10.18699577,-0.187347049,0.070255143,38.85109422,38.92134937
50,3,7,40,89,Oklahoma,McCurtain County,30814,30786,30884,-28,98,89,446,125,500,-36,-54,1,24,9,125,10,149,-2,3,254,254,254,14.46408302,16.21533971,-1.751256689,0.778336306,4.053834928,4.832171234
50,3,7,40,91,Oklahoma,McIntosh County,18941,18946,19245,5,299,34,179,77,374,-43,-195,0,0,50,502,50,502,-2,-8,225,225,225,9.373936268,19.58576628,-10.21183001,0,26.28891624,26.28891624
50,3,7,40,93,Oklahoma,Major County,7782,7750,7668,-32,-82,11,76,18,82,-7,-6,0,1,-25,-77,-25,-76,0,0,69,69,69,9.858606823,10.63691789,-0.778311065,0.129718511,-9.988325334,-9.858606823
50,3,7,40,95,Oklahoma,Marshall County,15312,15342,15594,30,252,47,200,49,222,-2,-22,0,6,33,269,33,275,-1,-1,169,169,169,12.92991983,14.35221102,-1.422291182,0.387897595,17.39074218,17.77863977
50,3,7,40,97,Oklahoma,Mayes County,39046,39066,39159,20,93,121,416,134,654,-13,-238,0,3,34,327,34,330,-1,1,384,384,384,10.63598594,16.72099712,-6.085011186,0.076701822,8.360498562,8.437200384
50,3,7,40,99,Oklahoma,Murray County,13904,13869,13718,-35,-151,48,150,63,220,-15,-70,0,3,-19,-86,-19,-83,-1,2,258,258,258,10.87468735,15.94954145,-5.074854098,0.217493747,-6.234820749,-6.017327002
50,3,7,40,101,Oklahoma,Muskogee County,66339,66160,66146,-179,-14,198,807,281,1095,-83,-288,-1,13,-95,250,-96,263,0,11,3154,3154,3154,12.19899324,16.5525373,-4.353544057,0.196514142,3.779118105,3.975632247
50,3,7,40,103,Oklahoma,Noble County,10924,10900,10933,-24,33,29,121,43,147,-14,-26,0,2,-8,55,-8,57,-2,2,192,192,192,11.08413869,13.46585444,-2.381715751,0.183208904,5.038244859,5.221453763
50,3,7,40,105,Oklahoma,Nowata County,9320,9296,9303,-24,7,21,88,40,160,-19,-72,0,2,-4,77,-4,79,-1,0,78,78,78,9.462874348,17.20522609,-7.742351739,0.215065326,8.280015055,8.495080381
50,3,7,40,107,Oklahoma,Okfuskee County,11310,11238,11197,-72,-41,33,130,64,204,-31,-74,0,1,-40,32,-40,33,-1,0,1053,1053,1053,11.58903499,18.18587029,-6.596835302,0.089146423,2.852685536,2.941831959
50,3,7,40,109,Oklahoma,Oklahoma County,796292,797296,798575,1004,1279,2681,10809,2273,8767,408,2042,35,343,537,-1277,572,-934,24,171,14090,14090,14090,13.54620768,10.98710359,2.559104088,0.429859306,-1.600379981,-1.170520675
50,3,7,40,111,Oklahoma,Okmulgee County,36706,36679,36843,-27,164,115,444,135,645,-20,-201,0,1,-7,363,-7,364,0,1,1112,1112,1112,12.07801746,17.54576861,-5.467751149,0.027202742,9.874595359,9.901798101
50,3,7,40,113,Oklahoma,Osage County,45818,45741,45772,-77,31,107,381,147,631,-40,-250,0,1,-33,277,-33,278,-4,3,1348,1348,1348,8.326685826,13.79039044,-5.46370461,0.021854818,6.053784708,6.075639527
50,3,7,40,115,Oklahoma,Ottawa County,30285,30209,30340,-76,131,80,372,111,545,-31,-173,0,3,-43,302,-43,305,-2,-1,827,827,827,12.28756875,18.00194884,-5.714380089,0.099093296,9.975391831,10.07448513
50,3,7,40,117,Oklahoma,Pawnee County,15553,15544,15741,-9,197,46,171,57,248,-11,-77,0,1,3,276,3,277,-1,-3,116,116,116,10.93175643,15.85424325,-4.922486815,0.0639284,17.64423845,17.70816685
50,3,7,40,119,Oklahoma,Payne County,81646,81592,81989,-54,397,187,757,171,786,16,-29,5,139,-79,269,-74,408,4,18,7636,7636,7636,9.255353617,9.609918022,-0.354564405,1.699463874,3.288890519,4.988354393
50,3,7,40,121,Oklahoma,Pittsburg County,43773,43727,43633,-46,-94,114,476,185,699,-71,-223,0,2,28,121,28,123,-3,6,2310,2310,2310,10.8974359,16.00274725,-5.105311355,0.045787546,2.77014652,2.815934066
50,3,7,40,123,Oklahoma,Pontotoc County,38065,38077,38163,12,86,124,512,130,550,-6,-38,0,5,18,113,18,118,0,6,1553,1553,1553,13.43126968,14.42812172,-0.996852046,0.131164743,2.96432319,3.095487933
50,3,7,40,125,Oklahoma,Pottawatomie County,72454,72441,73019,-13,578,190,844,276,1002,-86,-158,0,5,73,729,73,734,0,2,2852,2852,2852,11.60456483,13.77698336,-2.172418534,0.068747422,10.02337412,10.09212155
50,3,7,40,127,Oklahoma,Pushmataha County,10812,10797,10815,-15,18,28,119,44,191,-16,-72,0,0,2,89,2,89,-1,1,76,76,76,11.01240052,17.67536554,-6.662965019,0,8.236165094,8.236165094
50,3,7,40,129,Oklahoma,Roger Mills County,3442,3427,3386,-15,-41,7,36,15,34,-8,2,0,0,-7,-43,-7,-43,0,0,6,6,6,10.5680317,9.980918832,0.587112872,0,-12.62292676,-12.62292676
50,3,7,40,131,Oklahoma,Rogers County,95240,95315,96695,75,1380,225,947,250,1107,-25,-160,3,8,100,1542,103,1550,-3,-10,1159,1159,1159,9.86406958,11.53064945,-1.666579866,0.083328993,16.06166346,16.14499245
50,3,7,40,133,Oklahoma,Seminole County,23556,23508,23567,-48,59,64,259,102,364,-38,-105,0,3,-8,161,-8,164,-2,0,432,432,432,11.00371747,15.46468402,-4.460966543,0.127456187,6.840148699,6.967604886
50,3,7,40,135,Oklahoma,Sequoyah County,39281,39255,39508,-26,253,121,508,140,669,-19,-161,0,5,-6,409,-6,414,-1,0,295,295,295,12.89945787,16.98767188,-4.088214009,0.126963168,10.38558714,10.51255031
50,3,7,40,137,Oklahoma,Stephens County,42848,42753,43129,-95,376,121,472,188,632,-67,-160,0,6,-25,533,-25,539,-3,-3,448,448,448,10.99182599,14.7178687,-3.72604271,0.139726602,12.41237978,12.55210638
50,3,7,40,139,Oklahoma,Texas County,21384,21283,20865,-101,-418,85,336,54,178,31,158,1,50,-134,-619,-133,-569,1,-7,583,583,583,15.94381703,8.446426877,7.497390149,2.372591819,-29.37268672,-27.0000949
50,3,7,40,141,Oklahoma,Tillman County,6968,6956,7076,-12,120,24,68,28,89,-4,-21,0,6,-7,137,-7,143,-1,-2,202,202,202,9.692132269,12.68529076,-2.993158495,0.855188141,19.5267959,20.38198404
50,3,7,40,143,Oklahoma,Tulsa County,669279,670157,672858,878,2701,2038,8539,1816,7380,222,1159,10,418,634,965,644,1383,12,159,9662,9662,9662,12.71616475,10.99019743,1.72596732,0.622480017,1.437065111,2.059545128
50,3,7,40,145,Oklahoma,Wagoner County,80981,81377,84050,396,2673,240,826,186,906,54,-80,1,14,341,2778,342,2792,0,-39,214,214,214,9.986277935,10.95347192,-0.967193989,0.169258948,33.58581126,33.75507021
50,3,7,40,147,Oklahoma,Washington County,52455,52593,52772,138,179,157,555,169,775,-12,-220,0,25,152,372,152,397,-2,2,723,723,723,10.53480757,14.71076733,-4.175959759,0.474540882,7.06116832,7.535709201
50,3,7,40,149,Oklahoma,Washita County,10924,10903,10915,-21,12,40,144,39,149,1,-5,0,2,-21,13,-21,15,-1,2,170,170,170,13.20011,13.65844715,-0.458337153,0.183334861,1.191676597,1.375011458
50,3,7,40,151,Oklahoma,Woods County,8624,8587,8583,-37,-4,14,85,27,124,-13,-39,0,1,-24,32,-24,33,0,2,934,934,934,9.900990099,14.44379732,-4.542807222,0.116482237,3.727431567,3.843913803
50,3,7,40,153,Oklahoma,Woodward County,20470,20385,20205,-85,-180,47,242,52,273,-5,-31,0,8,-80,-160,-80,-152,0,3,1227,1227,1227,11.92411924,13.45158906,-1.52746982,0.39418576,-7.883715201,-7.489529441
40,4,9,41,0,Oregon,Oregon,4237256,4241544,4246155,4288,4611,10425,39877,11334,44592,-909,-4715,64,1101,5246,8080,5310,9181,-113,145,85284,85284,85284,9.39642181,10.50744142,-1.111019606,0.259434271,1.903931796,2.163366067
50,4,9,41,1,Oregon,Baker County,16668,16689,16847,21,158,36,162,72,243,-36,-81,0,4,59,237,59,241,-2,-2,358,358,358,9.661259542,14.49188931,-4.830629771,0.238549618,14.13406489,14.3726145
50,4,9,41,3,Oregon,Benton County,95184,95167,96017,-17,850,180,634,172,707,8,-73,5,118,-29,798,-24,916,-1,7,5901,5901,5901,6.632354172,7.396016403,-0.763662231,1.234412922,8.34797891,9.582391832
50,4,9,41,5,Oregon,Clackamas County,421401,422160,422537,759,377,988,3695,1045,4367,-57,-672,-5,69,839,911,834,980,-18,69,2697,2697,2697,8.748699238,10.33980232,-1.591103082,0.163372191,2.15698647,2.320358661
50,4,9,41,7,Oregon,Clatsop County,41072,41089,41810,17,721,76,367,122,488,-46,-121,-1,5,68,843,67,848,-4,-6,826,826,826,8.854147818,11.77336277,-2.919214948,0.120628717,20.33800167,20.45863038
50,4,9,41,9,Oregon,Columbia County,52589,52631,53074,42,443,124,482,163,597,-39,-115,0,-6,85,566,85,560,-4,-2,369,369,369,9.119719975,11.29558678,-2.175866799,-0.113523485,10.70904877,10.59552528
50,4,9,41,11,Oregon,Coos County,64929,64887,64999,-42,112,146,557,295,1042,-149,-485,0,1,116,597,116,598,-9,-1,1109,1109,1109,8.576751921,16.04483932,-7.4680874,0.015398118,9.192676655,9.208074773
50,4,9,41,13,Oregon,Crook County,24738,24923,25739,185,816,63,229,69,286,-6,-57,0,-2,193,889,193,887,-2,-14,158,158,158,9.040306344,11.2905136,-2.250207256,-0.078954641,35.09533773,35.01638309
50,4,9,41,15,Oregon,Curry County,23446,23503,23683,57,180,42,160,126,499,-84,-339,0,-3,145,529,145,526,-4,-7,266,266,266,6.78167253,21.1503412,-14.36866867,-0.12715636,22.4219048,22.29474844
50,4,9,41,17,Oregon,Deschutes County,198253,199355,204801,1102,5446,483,1789,426,1913,57,-124,-1,-25,1050,5663,1049,5638,-4,-68,1207,1207,1207,8.853017152,9.466641594,-0.613624442,-0.123714605,28.02383238,27.90011778
50,4,9,41,19,Oregon,Douglas County,111201,111235,111978,34,743,284,994,483,1787,-199,-793,1,-6,247,1553,248,1547,-15,-11,1714,1714,1714,8.9062913,16.01161223,-7.105320927,-0.05376031,13.91496015,13.86119984
50,4,9,41,21,Oregon,Gilliam County,1995,2016,2005,21,-11,5,17,3,30,2,-13,0,0,20,1,20,1,-1,1,16,16,16,8.455608058,14.92166128,-6.466053221,0,0.497388709,0.497388709
50,4,9,41,23,Oregon,Grant County,7233,7223,7272,-10,49,15,58,36,92,-21,-34,0,0,12,84,12,84,-1,-1,109,109,109,8.002759572,12.69403243,-4.691272853,0,11.59020352,11.59020352
50,4,9,41,25,Oregon,Harney County,7495,7491,7575,-4,84,17,71,24,100,-7,-29,0,0,5,113,5,113,-2,0,150,150,150,9.425195805,13.27492367,-3.849727864,0,15.00066375,15.00066375
50,4,9,41,27,Oregon,Hood River County,23977,23943,24057,-34,114,55,232,51,202,4,30,-1,3,-36,78,-37,81,-1,3,773,773,773,9.666666667,8.416666667,1.25,0.125,3.25,3.375
50,4,9,41,29,Oregon,Jackson County,223259,223394,223734,135,340,530,2086,733,2903,-203,-817,1,-17,356,1162,357,1145,-19,12,3387,3387,3387,9.330661466,12.98509599,-3.654434524,-0.076040865,5.19761679,5.121575925
50,4,9,41,31,Oregon,Jefferson County,24502,24518,25068,16,550,70,292,98,311,-28,-19,0,0,46,574,46,574,-2,-5,859,859,859,11.77751785,12.54386319,-0.766345339,0,23.15169604,23.15169604
50,4,9,41,33,Oregon,Josephine County,88090,88105,88346,15,241,195,748,388,1443,-193,-695,0,4,220,936,220,940,-12,-4,1520,1520,1520,8.478274422,16.3558155,-7.877541074,0.045338366,10.60917762,10.65451599
50,4,9,41,35,Oregon,Klamath County,69413,69504,70164,91,660,207,758,243,1002,-36,-244,-1,-4,133,911,132,907,-5,-3,1144,1144,1144,10.85431165,14.34831171,-3.494000057,-0.057278689,13.04522153,12.98794284
50,4,9,41,37,Oregon,Lake County,8160,8149,8276,-11,127,12,81,33,108,-21,-27,0,5,12,149,12,154,-2,0,462,462,462,9.863013699,13.15068493,-3.287671233,0.608828006,18.14307458,18.75190259
50,4,9,41,39,Oregon,Lane County,382971,382940,383189,-31,249,737,3061,1105,4449,-368,-1388,-2,82,360,1501,358,1583,-21,54,8570,8570,8570,7.990821389,11.61423207,-3.623410679,0.214063167,3.918400165,4.132463332
50,4,9,41,41,Oregon,Lincoln County,50395,50472,50862,77,390,90,369,195,762,-105,-393,0,6,191,783,191,789,-9,-6,786,786,786,7.282846823,15.03937474,-7.756527918,0.118420274,15.4538457,15.57226597
50,4,9,41,43,Oregon,Linn County,128610,128936,129839,326,903,380,1430,401,1640,-21,-210,-1,7,352,1099,351,1106,-4,7,1000,1000,1000,11.05207226,12.67510386,-1.623031591,0.054101053,8.493865327,8.54796638
50,4,9,41,45,Oregon,Malheur County,31571,31608,31693,37,85,126,377,132,328,-6,49,0,7,43,22,43,29,0,7,3294,3294,3294,11.91134421,10.36318542,1.548158797,0.221165542,0.695091705,0.916257247
50,4,9,41,47,Oregon,Marion County,345920,346202,347119,282,917,1009,3916,883,3522,126,394,1,-2,153,460,154,458,2,65,10078,10078,10078,11.29635479,10.15979611,1.136558679,-0.005769333,1.326946681,1.321177348
50,4,9,41,49,Oregon,Morrow County,12186,12191,12303,5,112,31,172,29,126,2,46,0,9,2,56,2,65,1,1,22,22,22,14.04425574,10.28823385,3.756021883,0.734873847,4.572548379,5.307422226
50,4,9,41,51,Oregon,Multnomah County,815428,815871,803377,443,-12494,2033,7481,1810,7284,223,197,33,366,163,-12983,196,-12617,24,-74,18592,18592,18592,9.240091697,8.996768871,0.243322826,0.452061698,-16.03583886,-15.58377716
50,4,9,41,53,Oregon,Polk County,87433,87863,89164,430,1301,211,856,242,863,-31,-7,3,12,459,1301,462,1313,-1,-5,1703,1703,1703,9.670841171,9.749925153,-0.079083982,0.13557254,14.69832286,14.83389539
50,4,9,41,55,Oregon,Sherman County,1870,1872,1907,2,35,5,19,4,20,1,-1,0,0,1,36,1,36,0,0,0,0,0,10.05557026,10.5848108,-0.52924054,0,19.05265943,19.05265943
50,4,9,41,57,Oregon,Tillamook County,27390,27471,27748,81,277,81,229,95,393,-14,-164,0,1,98,444,98,445,-3,-4,438,438,438,8.294246546,14.23423097,-5.939984426,0.036219417,16.08142125,16.11764067
50,4,9,41,59,Oregon,Umatilla County,80075,80011,79988,-64,-23,229,931,228,852,1,79,-2,-9,-63,-110,-65,-119,0,17,4142,4142,4142,11.63757274,10.65006656,0.987506172,-0.112500703,-1.375008594,-1.487509297
50,4,9,41,61,Oregon,Union County,26196,26149,26212,-47,63,70,239,87,327,-17,-88,0,6,-29,143,-29,149,-1,2,770,770,770,9.128931839,12.49021218,-3.361280342,0.229178205,5.462080556,5.691258761
50,4,9,41,63,Oregon,Wallowa County,7391,7387,7545,-4,158,12,62,22,83,-10,-21,0,0,8,183,8,183,-2,-4,97,97,97,8.304312885,11.11706402,-2.812751138,0,24.51111706,24.51111706
50,4,9,41,65,Oregon,Wasco County,26670,26611,26726,-59,115,74,267,103,331,-29,-64,0,1,-28,177,-28,178,-2,1,680,680,680,10.01181169,12.4116467,-2.399835011,0.037497422,6.637043703,6.674541125
50,4,9,41,67,Oregon,Washington County,600372,600689,600811,317,122,1533,6035,1079,4377,454,1658,32,474,-183,-2111,-151,-1637,14,101,6938,6938,6938,10.04577611,7.285892634,2.759883479,0.789013733,-3.513940907,-2.724927174
50,4,9,41,69,Oregon,Wheeler County,1451,1457,1451,6,-6,2,10,9,18,-7,-8,0,0,13,3,13,3,0,-1,22,22,22,6.877579092,12.37964237,-5.502063274,0,2.063273728,2.063273728
50,4,9,41,71,Oregon,Yamhill County,107722,107832,108239,110,407,274,1011,328,1097,-54,-86,2,-5,165,482,167,477,-3,16,5127,5127,5127,9.35803509,10.15406973,-0.796034637,-0.046281084,4.461496453,4.415215369
40,1,2,42,0,Pennsylvania,Pennsylvania,13002700,12989625,12964056,-13075,-25569,32214,128351,39879,159229,-7665,-30878,439,7467,-5302,-3194,-4863,4273,-547,1036,410509,410509,410509,9.890774261,12.27024406,-2.379469795,0.575409708,-0.24613079,0.329278918
50,1,2,42,1,Pennsylvania,Adams County,103852,103795,104127,-57,332,213,850,300,1213,-87,-363,0,8,38,680,38,688,-8,7,3951,3951,3951,8.176142977,11.66783698,-3.491694001,0.076951934,6.540914381,6.617866315
50,1,2,42,3,Pennsylvania,Allegheny County,1250578,1248717,1238090,-1861,-10627,3123,12280,3972,16142,-849,-3862,47,762,-994,-7635,-947,-6873,-65,108,35053,35053,35053,9.876118251,12.98210919,-3.105990935,0.612834048,-6.140404141,-5.527570093
50,1,2,42,5,Pennsylvania,Armstrong County,65558,65445,65093,-113,-352,180,580,248,1028,-68,-448,0,0,-39,88,-39,88,-6,8,607,607,607,8.886301307,15.75020301,-6.863901699,0,1.348266405,1.348266405
50,1,2,42,7,Pennsylvania,Beaver County,168215,167732,166624,-483,-1108,367,1473,650,2490,-283,-1017,1,13,-187,-130,-186,-117,-14,26,3149,3149,3149,8.81096795,14.89430427,-6.083336324,0.077761428,-0.777614279,-0.699852851
50,1,2,42,9,Pennsylvania,Bedford County,47577,47523,47461,-54,-62,116,446,175,679,-59,-233,0,4,11,161,11,165,-6,6,476,476,476,9.391055336,14.29714478,-4.906089447,0.084224712,3.390044639,3.474269351
50,1,2,42,11,Pennsylvania,Berks County,428849,428694,429342,-155,648,1135,4484,1188,4792,-53,-308,39,389,-130,487,-91,876,-11,80,11304,11304,11304,10.45177592,11.16969451,-0.717918595,0.906721863,1.135150507,2.041872369
50,1,2,42,13,Pennsylvania,Blair County,122822,122518,121767,-304,-751,280,1167,477,1868,-197,-701,0,6,-98,-78,-98,-72,-9,22,3609,3609,3609,9.554413902,15.29361197,-5.739198068,0.049122951,-0.638598358,-0.589475408
50,1,2,42,15,Pennsylvania,Bradford County,59967,59858,59892,-109,34,151,603,233,841,-82,-238,0,11,-21,256,-21,267,-6,5,573,573,573,10.07098121,14.04592902,-3.974947808,0.183716075,4.275574113,4.459290188
50,1,2,42,17,Pennsylvania,Bucks County,646538,646008,646098,-530,90,1349,5357,1911,7370,-562,-2013,-5,160,73,1861,68,2021,-36,82,8098,8098,8098,8.291889365,11.4077328,-3.115843437,0.2476577,2.880568622,3.128226322
50,1,2,42,19,Pennsylvania,Butler County,193763,193851,194273,88,422,413,1582,605,2490,-192,-908,5,41,285,1271,290,1312,-10,18,5450,5450,5450,8.152033886,12.83095093,-4.678917047,0.211272686,6.549453268,6.760725954
50,1,2,42,21,Pennsylvania,Cambria County,133472,132957,132167,-515,-790,305,1154,604,2076,-299,-922,-1,4,-202,112,-203,116,-13,16,5985,5985,5985,8.705360511,15.66059655,-6.95523604,0.03017456,0.844887675,0.875062235
50,1,2,42,23,Pennsylvania,Cameron County,4547,4519,4459,-28,-60,4,23,17,59,-13,-36,0,0,-14,-23,-14,-23,-1,-1,89,89,89,5.123635554,13.14323903,-8.019603475,0,-5.123635554,-5.123635554
50,1,2,42,25,Pennsylvania,Carbon County,64749,64751,65412,2,661,131,501,189,926,-58,-425,0,4,66,1094,66,1098,-6,-12,635,635,635,7.69804015,14.22831373,-6.53027358,0.061461398,16.80969246,16.87115386
50,1,2,42,27,Pennsylvania,Centre County,158172,157929,157527,-243,-402,289,1006,287,1328,2,-322,10,272,-258,-384,-248,-112,3,32,18682,18682,18682,6.378068574,8.41955772,-2.041489146,1.724487726,-2.434570907,-0.710083181
50,1,2,42,29,Pennsylvania,Chester County,534413,534645,538649,232,4004,1296,5139,1182,5020,114,119,13,210,115,3634,128,3844,-10,41,13313,13313,13313,9.576127324,9.354380067,0.221747257,0.391318688,6.771676726,7.162995414
50,1,2,42,31,Pennsylvania,Clarion County,37241,37178,37156,-63,-22,91,401,131,489,-40,-88,0,4,-21,56,-21,60,-2,6,1627,1627,1627,10.78914091,13.15683267,-2.36769177,0.107622353,1.506712944,1.614335297
50,1,2,42,33,Pennsylvania,Clearfield County,80562,80394,80082,-168,-312,200,679,292,1168,-92,-489,0,14,-71,152,-71,166,-5,11,5701,5701,5701,8.462324584,14.55669384,-6.094369251,0.174480919,1.894364266,2.068845186
50,1,2,42,35,Pennsylvania,Clinton County,37450,37350,37465,-100,115,110,375,125,489,-15,-114,0,3,-84,222,-84,225,-1,4,1641,1641,1641,10.02472766,13.07224487,-3.047517209,0.080197821,5.934638776,6.014836597
50,1,2,42,37,Pennsylvania,Columbia County,64727,64667,64872,-60,205,143,542,217,835,-74,-293,0,3,17,494,17,497,-3,1,3415,3415,3415,8.368136237,12.8918704,-4.523734165,0.046318097,7.627046681,7.673364778
50,1,2,42,39,Pennsylvania,Crawford County,83938,83723,83351,-215,-372,223,829,285,1217,-62,-388,0,7,-147,-2,-147,5,-6,11,3592,3592,3592,9.923746364,14.56839484,-4.644648479,0.083795205,-0.023941487,0.059853718
50,1,2,42,41,Pennsylvania,Cumberland County,259469,259996,262919,527,2923,648,2469,716,2893,-68,-424,-2,136,608,3221,606,3357,-11,-10,11813,11813,11813,9.443217349,11.06489582,-1.621678475,0.52016102,12.31940182,12.83956284
50,1,2,42,43,Pennsylvania,Dauphin County,286401,286544,287400,143,856,788,3126,729,3121,59,5,7,254,83,548,90,802,-6,49,7052,7052,7052,10.8930488,10.8756255,0.017423303,0.885103773,1.909593967,2.794697741
50,1,2,42,45,Pennsylvania,Delaware County,576830,576388,573849,-442,-2539,1508,6056,1692,6639,-184,-583,19,403,-270,-2460,-251,-2057,-7,101,22265,22265,22265,10.53000382,11.54370795,-1.013704132,0.700725155,-4.277379357,-3.576654203
50,1,2,42,47,Pennsylvania,Elk County,30990,30927,30783,-63,-144,65,289,82,440,-17,-151,0,-1,-42,5,-42,4,-4,3,339,339,339,9.366391185,14.26024955,-4.89385837,-0.032409658,0.16204829,0.129638632
50,1,2,42,49,Pennsylvania,Erie County,270876,270427,269011,-449,-1416,700,2641,851,3483,-151,-842,4,142,-292,-761,-288,-619,-10,45,11980,11980,11980,9.791672074,12.91343954,-3.121767469,0.526473849,-2.821454922,-2.294981073
50,1,2,42,51,Pennsylvania,Fayette County,128804,128393,126931,-411,-1462,332,1138,567,2127,-235,-989,1,17,-167,-504,-166,-487,-10,14,4114,4114,4114,8.914163964,16.66118344,-7.747019473,0.133164137,-3.947924989,-3.814760853
50,1,2,42,53,Pennsylvania,Forest County,6973,6952,7032,-21,80,7,29,27,103,-20,-74,0,0,0,156,0,156,-1,-2,2398,2398,2398,4.147597254,14.73112128,-10.58352403,0,22.31121282,22.31121282
50,1,2,42,55,Pennsylvania,Franklin County,155932,155874,156289,-58,415,423,1679,470,1932,-47,-253,0,87,-4,559,-4,646,-7,22,2539,2539,2539,10.75720057,12.3781486,-1.62094803,0.557401101,3.581462249,4.13886335
50,1,2,42,57,Pennsylvania,Fulton County,14556,14549,14523,-7,-26,35,140,45,183,-10,-43,0,0,5,15,5,15,-2,2,100,100,100,9.631260319,12.58943313,-2.958172812,0,1.031920749,1.031920749
50,1,2,42,59,Pennsylvania,Greene County,35954,35813,35369,-141,-444,74,297,137,505,-63,-208,0,-2,-77,-235,-77,-237,-1,1,2909,2909,2909,8.344806271,14.18898036,-5.844174089,-0.056193982,-6.602792841,-6.658986823
50,1,2,42,61,Pennsylvania,Huntingdon County,44092,44030,43889,-62,-141,87,348,106,630,-19,-282,0,4,-39,131,-39,135,-4,6,4651,4651,4651,7.916377575,14.3313732,-6.414995621,0.090992846,2.980015696,3.071008542
50,1,2,42,63,Pennsylvania,Indiana County,83246,83116,82886,-130,-230,196,748,264,1078,-68,-330,0,17,-57,67,-57,84,-5,16,4795,4795,4795,9.011939615,12.98779533,-3.975855713,0.204816809,0.80721919,1.012036
50,1,2,42,65,Pennsylvania,Jefferson County,44492,44431,44114,-61,-317,123,446,157,635,-34,-189,0,0,-24,-134,-24,-134,-3,6,724,724,724,10.07397369,14.34298944,-4.269015755,0,-3.026709583,-3.026709583
50,1,2,42,67,Pennsylvania,Juniata County,23509,23451,23297,-58,-154,48,255,65,298,-17,-43,0,4,-41,-115,-41,-111,0,0,195,195,195,10.90955763,12.74920852,-1.839650894,0.171130316,-4.919996577,-4.748866262
50,1,2,42,69,Pennsylvania,Lackawanna County,215896,215516,215663,-380,147,498,1980,742,2944,-244,-964,0,164,-124,927,-124,1091,-12,20,7655,7655,7655,9.184120748,13.65558156,-4.471460809,0.760704951,4.29983835,5.060543301
50,1,2,42,71,Pennsylvania,Lancaster County,552984,552597,553652,-387,1055,1522,6685,1585,6149,-63,536,11,322,-316,86,-305,408,-19,111,12323,12323,12323,12.08588663,11.11684621,0.969040424,0.582147419,0.155480367,0.737627785
50,1,2,42,73,Pennsylvania,Lawrence County,86070,85865,85497,-205,-368,193,773,360,1284,-167,-511,0,5,-29,124,-29,129,-9,14,2012,2012,2012,9.021836813,14.98581949,-5.96398268,0.058355995,1.447228674,1.505584669
50,1,2,42,75,Pennsylvania,Lebanon County,143257,143242,143493,-15,251,383,1530,443,1843,-60,-313,4,118,49,420,53,538,-8,26,3563,3563,3563,10.67187473,12.85507524,-2.183200516,0.82305962,2.929534239,3.752593858
50,1,2,42,77,Pennsylvania,Lehigh County,374557,374504,375539,-53,1035,1015,4155,1026,4025,-11,130,39,544,-75,284,-36,828,-6,77,8737,8737,8737,11.07936478,10.73271799,0.346646792,1.4505835,0.757289915,2.207873415
50,1,2,42,79,Pennsylvania,Luzerne County,325594,325057,326053,-537,996,767,3125,1269,4729,-502,-1604,8,309,-23,2278,-15,2587,-20,13,11750,11750,11750,9.59899249,14.52596336,-4.926970865,0.949148377,6.997281565,7.946429943
50,1,2,42,81,Pennsylvania,Lycoming County,114188,113980,113605,-208,-375,282,1117,435,1544,-153,-427,0,35,-49,-3,-49,32,-6,20,5194,5194,5194,9.816112661,13.5685568,-3.752444142,0.307577389,-0.026363776,0.281213613
50,1,2,42,83,Pennsylvania,McKean County,40432,40306,39941,-126,-365,82,357,176,609,-94,-252,1,5,-31,-124,-30,-119,-2,6,2867,2867,2867,8.89752888,15.1781375,-6.280608621,0.12461525,-3.09045821,-2.96584296
50,1,2,42,85,Pennsylvania,Mercer County,110652,110333,109972,-319,-361,237,957,466,1695,-229,-738,-2,10,-79,356,-81,366,-9,11,6045,6045,6045,8.687955335,15.38775788,-6.699802546,0.090783232,3.231883071,3.322666304
50,1,2,42,87,Pennsylvania,Mifflin County,46143,46073,46136,-70,63,124,532,173,666,-49,-134,0,3,-17,189,-17,192,-4,5,483,483,483,11.53900379,14.44544459,-2.906440803,0.06506957,4.099382924,4.164452494
50,1,2,42,89,Pennsylvania,Monroe County,168327,168248,169273,-79,1025,345,1427,465,1945,-120,-518,-2,72,49,1473,47,1545,-6,-2,3913,3913,3913,8.45577016,11.5252088,-3.069438642,0.42664012,8.728345792,9.154985912
50,1,2,42,91,Pennsylvania,Montgomery County,856553,856947,860578,394,3631,2046,8173,2319,9482,-273,-1309,33,411,665,4430,698,4841,-31,99,20831,20831,20831,9.517183156,11.04146956,-1.5242864,0.478595654,5.158585756,5.637181409
50,1,2,42,93,Pennsylvania,Montour County,18136,18115,18087,-21,-28,53,233,47,270,6,-37,0,6,-25,-1,-25,5,-2,4,778,778,778,12.87221701,14.91630297,-2.044085962,0.331473399,-0.055245567,0.276227833
50,1,2,42,95,Pennsylvania,Northampton County,312951,312855,313628,-96,773,686,2648,862,3560,-176,-912,3,186,94,1465,97,1651,-17,34,11145,11145,11145,8.453541437,11.36503305,-2.911491613,0.593791053,4.676902645,5.270693698
50,1,2,42,97,Pennsylvania,Northumberland County,91647,91471,91266,-176,-205,216,875,347,1309,-131,-434,1,12,-39,205,-38,217,-7,12,3495,3495,3495,9.576604629,14.32660052,-4.749995896,0.131336292,2.243661656,2.374997948
50,1,2,42,99,Pennsylvania,Perry County,45842,45821,45986,-21,165,136,514,127,526,9,-12,0,0,-29,171,-29,171,-1,6,582,582,582,11.19740325,11.45882122,-0.261417975,0,3.725206139,3.725206139
50,1,2,42,101,Pennsylvania,Philadelphia County,1603797,1601005,1576251,-2792,-24754,4796,19463,4262,17769,534,1694,203,1999,-3557,-28226,-3354,-26227,28,-221,55395,55395,55395,12.2514522,11.18512326,1.066328933,1.258318499,-17.76753274,-16.50921424
50,1,2,42,103,Pennsylvania,Pike County,58535,58591,59952,56,1361,94,378,135,626,-41,-248,0,9,103,1630,103,1639,-6,-30,463,463,463,6.377432662,10.56156838,-4.184135714,0.151843635,27.50056941,27.65241305
50,1,2,42,105,Pennsylvania,Potter County,16396,16356,16259,-40,-97,39,167,72,252,-33,-85,0,0,-5,-13,-5,-13,-2,1,163,163,163,10.2406868,15.45301242,-5.212325617,0,-0.797179212,-0.797179212
50,1,2,42,107,Pennsylvania,Schuylkill County,143049,142777,143264,-272,487,301,1267,608,2174,-307,-907,0,6,45,1394,45,1400,-10,-6,6557,6557,6557,8.858869882,15.20061809,-6.341748211,0.041952028,9.746854472,9.7888065
50,1,2,42,109,Pennsylvania,Snyder County,39736,39717,39621,-19,-96,99,373,97,486,2,-113,0,1,-19,10,-19,11,-2,6,2556,2556,2556,9.402808238,12.25138017,-2.848571933,0.025208601,0.252086012,0.277294613
50,1,2,42,111,Pennsylvania,Somerset County,74129,73917,73627,-212,-290,162,574,304,1111,-142,-537,0,0,-63,240,-63,240,-7,7,4848,4848,4848,7.780729816,15.05991433,-7.279184514,0,3.253266822,3.253266822
50,1,2,42,113,Pennsylvania,Sullivan County,5840,5838,5868,-2,30,24,47,30,123,-6,-76,0,0,5,107,5,107,-1,-1,325,325,325,8.03007005,21.01486417,-12.98479412,0,18.2812233,18.2812233
50,1,2,42,115,Pennsylvania,Susquehanna County,38434,38354,38389,-80,35,87,337,135,535,-48,-198,0,1,-28,231,-28,232,-4,1,190,190,190,8.782559973,13.94263972,-5.160079747,0.026061009,6.020093038,6.046154047
50,1,2,42,117,Pennsylvania,Tioga County,41045,40969,40929,-76,-40,107,383,140,540,-33,-157,0,4,-38,106,-38,110,-5,7,1277,1277,1277,9.353097756,13.18713522,-3.834037461,0.097682483,2.588585802,2.686268285
50,1,2,42,119,Pennsylvania,Union County,42681,42625,42568,-56,-57,92,388,108,468,-16,-80,0,8,-38,6,-38,14,-2,9,7926,7926,7926,9.108729591,10.98681817,-1.878088575,0.187808858,0.140856643,0.328665501
50,1,2,42,121,Pennsylvania,Venango County,50454,50275,49938,-179,-337,109,413,213,773,-104,-360,0,3,-70,12,-70,15,-5,8,1208,1208,1208,8.242443595,15.42714019,-7.184696596,0.059872472,0.239489887,0.299362358
50,1,2,42,123,Pennsylvania,Warren County,38587,38480,38134,-107,-346,84,372,162,584,-78,-212,0,3,-25,-140,-25,-137,-4,3,647,647,647,9.711018874,15.24525544,-5.534236563,0.078314668,-3.654684522,-3.576369854
50,1,2,42,125,Pennsylvania,Washington County,209349,209157,209470,-192,313,468,1980,789,3058,-321,-1078,0,23,145,1357,145,1380,-16,11,5219,5219,5219,9.459494968,14.60966445,-5.150169483,0.109883022,6.483098319,6.592981341
50,1,2,42,127,Pennsylvania,Wayne County,51155,51101,51431,-54,330,99,356,194,711,-95,-355,0,1,48,691,48,692,-7,-7,3657,3657,3657,6.944173526,13.86884095,-6.924667421,0.019506105,13.47871884,13.49822494
50,1,2,42,129,Pennsylvania,Westmoreland County,354663,353998,353057,-665,-941,731,2833,1369,5369,-638,-2536,0,9,12,1560,12,1569,-39,26,6885,6885,6885,8.013520872,15.18693737,-7.173416495,0.025457708,4.412669453,4.438127161
50,1,2,42,131,Pennsylvania,Wyoming County,26069,26001,26034,-68,33,57,220,94,386,-37,-166,0,2,-28,197,-28,199,-3,0,568,568,568,8.455847026,14.83616796,-6.380320938,0.076871337,7.571826655,7.648697992
50,1,2,42,133,Pennsylvania,York County,456438,456389,458696,-49,2307,1127,4587,1329,5097,-202,-510,2,220,168,2555,170,2775,-17,42,8428,8428,8428,10.0252982,11.13994875,-1.114650552,0.48082965,5.584180705,6.065010354
40,1,1,44,0,Rhode Island,Rhode Island,1097379,1096229,1095610,-1150,-619,2484,9717,3036,11967,-552,-2250,32,615,-599,890,-567,1505,-31,126,41796,41796,41796,8.866527149,10.91959765,-2.053070504,0.561172604,0.812103444,1.373276048
50,1,1,44,1,Rhode Island,Bristol County,50793,50750,50818,-43,68,77,283,137,600,-60,-317,0,0,20,384,20,384,-3,1,2811,2811,2811,5.572621298,11.8147448,-6.242123503,0,7.561436673,7.561436673
50,1,1,44,3,Rhode Island,Kent County,170363,170323,170715,-40,392,374,1362,577,2135,-203,-773,0,46,172,1105,172,1151,-9,14,1090,1090,1090,7.987379706,12.52059888,-4.533219172,0.26976466,6.480216281,6.749980941
50,1,1,44,5,Rhode Island,Newport County,85643,85388,85264,-255,-124,149,635,261,1024,-112,-389,0,26,-135,238,-135,264,-8,1,4129,4129,4129,7.442045801,12.00103134,-4.558985538,0.304713686,2.789302206,3.094015892
50,1,1,44,7,Rhode Island,Providence County,660741,660015,658221,-726,-1794,1674,6661,1700,6668,-26,-7,31,526,-733,-2427,-702,-1901,2,114,26809,26809,26809,10.10592944,10.11654969,-0.010620253,0.798036164,-3.682193477,-2.884157313
50,1,1,44,9,Rhode Island,Washington County,129839,129753,130592,-86,839,210,776,361,1540,-151,-764,1,17,77,1590,78,1607,-13,-4,6957,6957,6957,5.961320555,11.83045574,-5.869135186,0.13059594,12.21456145,12.34515739
40,3,5,45,0,South Carolina,South Carolina,5118425,5130729,5190705,12304,59976,13339,54713,15134,62520,-1795,-7807,192,3138,13979,64833,14171,67971,-72,-188,121594,121594,121594,10.60182141,12.1145957,-1.512774291,0.608055044,12.56278924,13.17084428
50,3,5,45,1,South Carolina,Abbeville County,24295,24212,24299,-83,87,54,232,109,324,-55,-92,0,0,-26,178,-26,178,-2,1,807,807,807,9.564840964,13.35779514,-3.792954175,0,7.338541774,7.338541774
50,3,5,45,3,South Carolina,Aiken County,168808,169032,170776,224,1744,391,1755,551,2274,-160,-519,4,54,386,2215,390,2269,-6,-6,2048,2048,2048,10.32936246,13.38402863,-3.054666164,0.317826537,13.03677371,13.35460025
50,3,5,45,5,South Carolina,Allendale County,8039,7990,7858,-49,-132,16,53,31,127,-15,-74,0,1,-34,-57,-34,-56,0,-2,826,826,826,6.688541141,16.02725896,-9.338717819,0.126198889,-7.193336699,-7.067137809
50,3,5,45,7,South Carolina,Anderson County,203718,204032,206908,314,2876,500,2080,699,2652,-199,-572,-1,68,519,3402,518,3470,-5,-22,2753,2753,2753,10.12313233,12.90699372,-2.783861391,0.330948557,16.55716163,16.88811019
50,3,5,45,9,South Carolina,Bamberg County,13311,13251,13189,-60,-62,22,149,44,211,-22,-62,0,4,-35,-7,-35,-3,-3,3,833,833,833,11.27080182,15.96066566,-4.689863843,0.302571861,-0.529500756,-0.226928896
50,3,5,45,11,South Carolina,Barnwell County,20589,20567,20580,-22,13,64,260,71,313,-7,-53,0,-3,-14,67,-14,64,-1,2,198,198,198,12.63761635,15.21374584,-2.576129487,-0.14581865,3.256616521,3.110797871
50,3,5,45,13,South Carolina,Beaufort County,187117,187691,191748,574,4057,439,1797,514,2166,-75,-369,16,110,659,4358,675,4468,-26,-42,5020,5020,5020,9.47187822,11.41685488,-1.944976663,0.579803341,22.97075419,23.55055753
50,3,5,45,15,South Carolina,Berkeley County,229861,231568,236701,1707,5133,686,2766,456,2093,230,673,18,215,1445,4265,1463,4480,14,-20,3394,3394,3394,11.81372245,8.939306254,2.874416201,0.918275607,18.2160254,19.13430101
50,3,5,45,17,South Carolina,Calhoun County,14119,14125,14165,6,40,20,123,40,223,-20,-100,0,2,27,139,27,141,-1,-1,90,90,90,8.695652174,15.76528809,-7.069635914,0.141392718,9.82679392,9.968186638
50,3,5,45,19,South Carolina,Charleston County,408235,409418,413024,1183,3606,1198,4766,975,4458,223,308,21,317,936,2967,957,3284,3,14,10495,10495,10495,11.58987503,10.84088604,0.748988987,0.770875028,7.215098451,7.985973479
50,3,5,45,21,South Carolina,Cherokee County,56216,56179,56052,-37,-127,156,603,203,797,-47,-194,0,20,10,35,10,55,0,12,975,975,975,10.74569415,14.20284948,-3.457155331,0.356407766,0.623713591,0.980121357
50,3,5,45,23,South Carolina,Chester County,32294,32276,32209,-18,-67,71,395,128,507,-57,-112,0,0,40,40,40,40,-1,5,163,163,163,12.25091107,15.72458711,-3.473676049,0,1.240598589,1.240598589
50,3,5,45,25,South Carolina,Chesterfield County,43273,43258,43268,-15,10,108,444,142,671,-34,-227,0,2,22,229,22,231,-3,6,578,578,578,10.26281118,15.50978897,-5.246977787,0.046228879,5.293206666,5.339435545
50,3,5,45,27,South Carolina,Clarendon County,31144,31093,31024,-51,-69,73,290,122,484,-49,-194,1,9,0,115,1,124,-3,1,1033,1033,1033,9.337218475,15.58349566,-6.246277187,0.289775746,3.702690085,3.992465831
50,3,5,45,29,South Carolina,Colleton County,38604,38543,38462,-61,-81,110,436,148,647,-38,-211,1,5,-21,122,-20,127,-3,3,349,349,349,11.32394,16.80410363,-5.480163626,0.129861697,3.168625414,3.298487111
50,3,5,45,31,South Carolina,Darlington County,62905,62833,62755,-72,-78,187,735,253,1033,-66,-298,0,17,-3,194,-3,211,-3,9,1144,1144,1144,11.70493996,16.4506163,-4.745676339,0.270726503,3.089467147,3.360193649
50,3,5,45,33,South Carolina,Dillon County,28292,28284,28087,-8,-197,94,407,107,436,-13,-29,0,12,5,-181,5,-169,0,1,297,297,297,14.44004896,15.4689468,-1.028897838,0.425750829,-6.421741676,-5.995990846
50,3,5,45,35,South Carolina,Dorchester County,161540,161975,163327,435,1352,424,1775,350,1562,74,213,6,134,352,984,358,1118,3,21,1794,1794,1794,10.91293629,9.603383933,1.309552354,0.823849838,6.04976299,6.873612828
50,3,5,45,37,South Carolina,Edgefield County,25657,25675,26153,18,478,44,180,73,317,-29,-137,0,8,48,615,48,623,-1,-8,2181,2181,2181,6.946052327,12.23276993,-5.286717604,0.308713437,23.73234545,24.04105889
50,3,5,45,39,South Carolina,Fairfield County,20948,20858,20690,-90,-168,45,182,100,355,-55,-173,0,1,-33,4,-33,5,-2,0,217,217,217,8.760951189,17.08866853,-8.327717339,0.048137094,0.192548378,0.240685472
50,3,5,45,41,South Carolina,Florence County,137059,136805,136504,-254,-301,352,1539,508,1961,-156,-422,0,22,-96,75,-96,97,-2,24,2708,2708,2708,11.2619782,14.35005799,-3.088079792,0.160989942,0.548829347,0.709819289
50,3,5,45,43,South Carolina,Georgetown County,63404,63440,63921,36,481,108,498,244,1038,-136,-540,0,-1,184,1028,184,1027,-12,-6,473,473,473,7.820290356,16.30012327,-8.479832916,-0.015703394,16.14308933,16.12738593
50,3,5,45,45,South Carolina,Greenville County,525534,526980,533834,1446,6854,1517,5996,1358,5456,159,540,54,774,1227,5507,1281,6281,6,33,9959,9959,9959,11.30452652,10.28644041,1.018086111,1.459256759,10.38259299,11.84184975
50,3,5,45,47,South Carolina,Greenwood County,69351,69380,69241,29,-139,207,796,223,954,-16,-158,0,28,47,-19,47,9,-2,10,2244,2244,2244,11.4845514,13.76414829,-2.279596886,0.403979195,-0.27412874,0.129850456
50,3,5,45,49,South Carolina,Hampton County,18561,18512,18180,-49,-332,49,185,71,310,-22,-125,0,0,-27,-204,-27,-204,0,-3,245,245,245,10.083942,16.89741633,-6.813474327,0,-11.1195901,-11.1195901
50,3,5,45,51,South Carolina,Horry County,351029,353498,365579,2469,12081,763,2985,1183,5123,-420,-2138,1,179,2910,14215,2911,14394,-22,-175,3346,3346,3346,8.302309767,14.24882175,-5.946511987,0.497860452,39.53679509,40.03465554
50,3,5,45,53,South Carolina,Jasper County,28791,29073,30324,282,1251,85,349,70,374,15,-25,2,23,265,1266,267,1289,0,-13,1013,1013,1013,11.75143526,12.59322861,-0.841793357,0.774449888,42.62841558,43.40286547
50,3,5,45,55,South Carolina,Kershaw County,65403,65536,66130,133,594,155,712,216,933,-61,-221,1,12,195,805,196,817,-2,-2,243,243,243,10.81524463,14.17222366,-3.356979023,0.182279404,12.22791002,12.41018942
50,3,5,45,57,South Carolina,Lancaster County,96016,96652,100336,636,3684,217,957,279,1320,-62,-363,0,11,701,4091,701,4102,-3,-55,1523,1523,1523,9.716327898,13.40183158,-3.685503686,0.11168193,41.53552501,41.64720694
50,3,5,45,59,South Carolina,Laurens County,67539,67551,67803,12,252,182,716,302,1029,-120,-313,0,42,133,518,133,560,-1,5,2051,2051,2051,10.57966517,15.20457467,-4.624909497,0.620594885,7.654003576,8.27459846
50,3,5,45,61,South Carolina,Lee County,16531,16458,16280,-73,-178,47,166,77,293,-30,-127,0,1,-43,-52,-43,-51,0,0,1546,1546,1546,10.14112041,17.89968844,-7.758568025,0.061091087,-3.176736514,-3.115645427
50,3,5,45,63,South Carolina,Lexington County,293991,294891,300137,900,5246,769,3031,798,3236,-29,-205,5,170,923,5317,928,5487,1,-36,1959,1959,1959,10.18775587,10.87679908,-0.689043205,0.571401682,17.8714279,18.44282958
50,3,5,45,65,South Carolina,McCormick County,9526,9513,9760,-13,247,13,47,57,184,-44,-137,0,-1,34,390,34,389,-3,-5,941,941,941,4.877289472,19.09406942,-14.21677995,-0.103772116,40.47112541,40.36735329
50,3,5,45,67,South Carolina,Marion County,29183,29043,28784,-140,-259,63,316,138,543,-75,-227,0,9,-63,-46,-63,-37,-2,5,121,121,121,10.92915074,18.7801546,-7.851003856,0.311273281,-1.590952323,-1.279679043
50,3,5,45,69,South Carolina,Marlboro County,26667,26537,26382,-130,-155,74,272,150,388,-76,-116,0,0,-52,-44,-52,-44,-2,5,2493,2493,2493,10.27986168,14.66392033,-4.384058656,0,-1.6629188,-1.6629188
50,3,5,45,71,South Carolina,Newberry County,37719,37715,37996,-4,281,104,407,136,528,-32,-121,0,8,29,394,29,402,-1,0,1155,1155,1155,10.75140997,13.94777509,-3.196365125,0.211329926,10.40799884,10.61932876
50,3,5,45,73,South Carolina,Oconee County,78607,78638,79203,31,565,143,663,303,1148,-160,-485,4,61,194,994,198,1055,-7,-5,627,627,627,8.400859092,14.54628392,-6.145424826,0.77292972,12.59495315,13.36788287
50,3,5,45,75,South Carolina,Orangeburg County,84223,83958,82962,-265,-996,211,909,316,1389,-105,-480,0,9,-155,-531,-155,-522,-5,6,2813,2813,2813,10.891445,16.64270309,-5.751258088,0.107836089,-6.36232926,-6.25449317
50,3,5,45,77,South Carolina,Pickens County,131404,131602,132229,198,627,320,1215,390,1531,-70,-316,5,77,264,850,269,927,-1,16,8460,8460,8460,9.210441533,11.60591439,-2.39547286,0.583706994,6.443518768,7.027225762
50,3,5,45,79,South Carolina,Richland County,416147,416527,418307,380,1780,1098,4719,925,3830,173,889,35,445,159,353,194,798,13,93,28006,28006,28006,11.30524152,9.175476801,2.12976472,1.066080203,0.845677105,1.911757307
50,3,5,45,81,South Carolina,Saluda County,18862,18830,18821,-32,-9,48,194,63,247,-15,-53,0,6,-15,34,-15,40,-2,4,180,180,180,10.30517118,13.12050145,-2.81533027,0.318716634,1.806060928,2.124777562
50,3,5,45,83,South Carolina,Spartanburg County,327997,329364,335864,1367,6500,939,3878,971,3957,-32,-79,7,122,1388,6510,1395,6632,4,-53,7562,7562,7562,11.65916047,11.89667302,-0.237512552,0.366791536,19.57223689,19.93902842
50,3,5,45,85,South Carolina,Sumter County,105556,105417,104758,-139,-659,348,1340,361,1333,-13,7,6,23,-132,-695,-126,-672,0,6,2329,2329,2329,12.7512787,12.68466754,0.066611157,0.218865231,-6.613536339,-6.394671107
50,3,5,45,87,South Carolina,Union County,27244,27148,27016,-96,-132,53,268,122,443,-69,-175,0,1,-25,36,-25,37,-2,6,393,393,393,9.895871797,16.35772838,-6.461856584,0.036924895,1.329296212,1.366221106
50,3,5,45,89,South Carolina,Williamsburg County,31026,30902,30484,-124,-418,58,286,124,462,-66,-176,0,8,-57,-248,-57,-240,-1,-2,902,902,902,9.318085557,15.05229205,-5.734206497,0.26064575,-8.080018245,-7.819372495
50,3,5,45,91,South Carolina,York County,282090,283899,288595,1809,4696,714,2841,633,2860,81,-19,6,133,1708,4605,1714,4738,14,-23,3107,3107,3107,9.924994847,9.991371089,-0.066376241,0.464633691,16.08750485,16.55213854
40,2,4,46,0,South Dakota,South Dakota,886667,887099,895376,432,8277,2881,10843,2496,9175,385,1668,45,1039,2,5564,47,6603,0,6,31569,31569,31569,12.16622954,10.29467454,1.871555001,1.165794752,6.243004811,7.408799562
50,2,4,46,3,South Dakota,Aurora County,2747,2733,2748,-14,15,5,43,8,33,-3,10,0,2,-10,2,-10,4,-1,1,91,91,91,15.69056742,12.04159825,3.648969166,0.729793833,0.729793833,1.459587667
50,2,4,46,5,South Dakota,Beadle County,19149,19146,19121,-3,-25,80,270,58,223,22,47,4,133,-28,-206,-24,-73,-1,1,601,601,601,14.11137534,11.65495074,2.456424596,6.951158962,-10.76645674,-3.815297776
50,2,4,46,7,South Dakota,Bennett County,3381,3386,3406,5,20,13,43,13,27,0,16,0,2,4,2,4,4,1,0,28,28,28,12.66195524,7.950530035,4.711425206,0.588928151,0.588928151,1.177856302
50,2,4,46,9,South Dakota,Bon Homme County,7003,6979,7014,-24,35,18,51,26,94,-8,-43,0,0,-16,77,-16,77,0,1,1549,1549,1549,7.289358965,13.43528907,-6.145930108,0,11.00550275,11.00550275
50,2,4,46,11,South Dakota,Brookings County,34375,34339,34639,-36,300,86,352,54,262,32,90,5,115,-75,87,-70,202,2,8,3359,3359,3359,10.20615269,7.596625011,2.609527676,3.334396474,2.52254342,5.856939894
50,2,4,46,13,South Dakota,Brown County,38301,38210,38101,-91,-109,108,404,103,395,5,9,2,51,-97,-174,-95,-123,-1,5,1217,1217,1217,10.58825071,10.35237384,0.235876872,1.33663561,-4.560286197,-3.223650588
50,2,4,46,15,South Dakota,Brule County,5247,5263,5242,16,-21,25,66,15,63,10,3,0,6,5,-29,5,-23,1,-1,115,115,115,12.56544503,11.99428843,0.571156592,1.142313184,-5.52118039,-4.378867206
50,2,4,46,17,South Dakota,Buffalo County,1948,1944,1923,-4,-21,12,31,10,30,2,1,0,0,-6,-21,-6,-21,0,-1,2,2,2,16.0331006,15.5159038,0.517196793,0,-10.86113266,-10.86113266
50,2,4,46,19,South Dakota,Butte County,10243,10249,10456,6,207,29,112,49,139,-20,-27,0,0,25,237,25,237,1,-3,71,71,71,10.81864284,13.42670853,-2.608065685,0,22.89302101,22.89302101
50,2,4,46,21,South Dakota,Campbell County,1377,1374,1380,-3,6,2,8,4,10,-2,-2,0,0,-1,8,-1,8,0,0,0,0,0,5.8097313,7.262164125,-1.452432825,0,5.8097313,5.8097313
50,2,4,46,23,South Dakota,Charles Mix County,9373,9351,9163,-22,-188,30,137,37,122,-7,15,0,0,-15,-202,-15,-202,0,-1,502,502,502,14.79961111,13.17921573,1.620395377,0,-21.8213244,-21.8213244
50,2,4,46,25,South Dakota,Clark County,3837,3850,3855,13,5,17,54,11,44,6,10,0,3,7,-7,7,-4,0,-1,485,485,485,14.01687216,11.42115509,2.595717067,0.77871512,-1.817001947,-1.038286827
50,2,4,46,27,South Dakota,Clay County,14967,14998,15150,31,152,35,118,27,106,8,12,0,12,22,127,22,139,1,1,2337,2337,2337,7.828048295,7.031975587,0.796072708,0.796072708,8.425102826,9.221175534
50,2,4,46,29,South Dakota,Codington County,28325,28309,28427,-16,118,67,294,84,318,-17,-24,2,15,-1,123,1,138,0,4,320,320,320,10.36379019,11.20981388,-0.846023689,0.528764805,4.335871404,4.86463621
50,2,4,46,31,South Dakota,Corson County,3902,3893,3872,-9,-21,24,94,16,53,8,41,0,0,-17,-61,-17,-61,0,-1,1,1,1,24.21120412,13.65099807,10.56020605,0,-15.71152608,-15.71152608
50,2,4,46,33,South Dakota,Custer County,8318,8328,8609,10,281,20,66,34,111,-14,-45,0,3,25,329,25,332,-1,-6,192,192,192,7.793588003,13.107398,-5.313810002,0.354254,38.84985535,39.20410935
50,2,4,46,35,South Dakota,Davison County,19956,19936,19878,-20,-58,64,247,54,261,10,-14,0,1,-30,-47,-30,-46,0,2,713,713,713,12.40769579,13.11096599,-0.703270206,0.050233586,-2.36097855,-2.310744964
50,2,4,46,37,South Dakota,Day County,5449,5425,5414,-24,-11,12,43,23,88,-11,-45,0,2,-13,33,-13,35,0,-1,119,119,119,7.934311283,16.2376603,-8.303349017,0.369037734,6.089122613,6.458160347
50,2,4,46,39,South Dakota,Deuel County,4295,4299,4272,4,-27,17,46,12,53,5,-7,0,1,-1,-20,-1,-19,0,-1,32,32,32,10.73387003,12.36728503,-1.633415004,0.233345001,-4.666900012,-4.433555011
50,2,4,46,41,South Dakota,Dewey County,5239,5226,5246,-13,20,27,111,11,66,16,45,0,0,-31,-24,-31,-24,2,-1,6,6,6,21.19938885,12.60504202,8.59434683,0,-4.583651642,-4.583651642
50,2,4,46,43,South Dakota,Douglas County,2835,2824,2821,-11,-3,10,45,16,38,-6,7,0,3,-4,-13,-4,-10,-1,0,141,141,141,15.94331267,13.46324181,2.480070859,1.062887511,-4.605845881,-3.54295837
50,2,4,46,45,South Dakota,Edmunds County,3986,3977,4033,-9,56,18,49,13,36,5,13,0,2,-14,41,-14,43,0,0,416,416,416,12.23470662,8.988764045,3.245942572,0.49937578,10.2372035,10.73657928
50,2,4,46,47,South Dakota,Fall River County,6973,6964,7202,-9,238,7,42,33,124,-26,-82,0,2,18,322,18,324,-1,-4,192,192,192,5.929690809,17.5067062,-11.57701539,0.282366229,45.46096287,45.7433291
50,2,4,46,49,South Dakota,Faulk County,2125,2128,2137,3,9,13,30,6,23,7,7,0,0,-3,1,-3,1,-1,1,355,355,355,14.06799531,10.78546307,3.282532239,0,0.468933177,0.468933177
50,2,4,46,51,South Dakota,Grant County,7556,7532,7519,-24,-13,29,71,26,113,3,-42,0,9,-26,20,-26,29,-1,0,101,101,101,9.434589064,15.01561358,-5.581024517,1.195933825,2.657630722,3.853564547
50,2,4,46,53,South Dakota,Gregory County,3994,3994,3977,0,-17,8,47,18,53,-10,-6,0,0,11,-11,11,-11,-1,0,24,24,24,11.79274871,13.298206,-1.505457283,0,-2.760005018,-2.760005018
50,2,4,46,55,South Dakota,Haakon County,1872,1869,1835,-3,-34,6,15,6,25,0,-10,0,0,-2,-24,-2,-24,-1,0,32,32,32,8.099352052,13.49892009,-5.399568035,0,-12.95896328,-12.95896328
50,2,4,46,57,South Dakota,Hamlin County,6164,6167,6255,3,88,37,123,16,88,21,35,0,8,-17,44,-17,52,-1,1,195,195,195,19.8035743,14.16841088,5.63516342,1.288037353,7.084205442,8.372242795
50,2,4,46,59,South Dakota,Hand County,3145,3130,3095,-15,-35,7,31,11,28,-4,3,0,2,-12,-38,-12,-36,1,-2,53,53,53,9.959839357,8.995983936,0.963855422,0.642570281,-12.20883534,-11.56626506
50,2,4,46,61,South Dakota,Hanson County,3461,3461,3505,0,44,10,39,8,16,2,23,0,0,-2,21,-2,21,0,0,487,487,487,11.19724376,4.593741028,6.603502728,0,6.029285099,6.029285099
50,2,4,46,63,South Dakota,Harding County,1311,1317,1327,6,10,8,12,1,8,7,4,0,-1,0,7,0,6,-1,0,29,29,29,9.077155825,6.051437216,3.025718608,-0.756429652,5.295007564,4.538577912
50,2,4,46,65,South Dakota,Hughes County,17765,17704,17694,-61,-10,58,195,71,214,-13,-19,0,1,-47,6,-47,7,-1,2,739,739,739,11.01757161,12.09107859,-1.073506978,0.056500367,0.339002204,0.395502571
50,2,4,46,67,South Dakota,Hutchinson County,7427,7411,7411,-16,0,24,93,34,94,-10,-1,0,1,-5,-1,-5,0,-1,1,811,811,811,12.54891378,12.68384833,-0.134934557,0.134934557,-0.134934557,0
50,2,4,46,69,South Dakota,Hyde County,1262,1258,1236,-4,-22,5,17,5,20,0,-3,0,0,-4,-18,-4,-18,0,-1,25,25,25,13.63271852,16.03849238,-2.405773857,0,-14.43464314,-14.43464314
50,2,4,46,71,South Dakota,Jackson County,2806,2810,2878,4,68,24,62,6,22,18,40,0,2,-14,26,-14,28,0,0,17,17,17,21.80028129,7.735583685,14.06469761,0.703234881,9.142053446,9.845288326
50,2,4,46,73,South Dakota,Jerauld County,1663,1657,1636,-6,-21,4,15,4,36,0,-21,0,1,-7,1,-7,2,1,-2,79,79,79,9.110233829,21.86456119,-12.75432736,0.607348922,0.607348922,1.214697844
50,2,4,46,75,South Dakota,Jones County,917,925,879,8,-46,4,6,1,10,3,-4,0,0,6,-41,6,-41,-1,-1,0,0,0,6.651884701,11.0864745,-4.4345898,0,-45.45454545,-45.45454545
50,2,4,46,77,South Dakota,Kingsbury County,5187,5211,5192,24,-19,21,52,15,65,6,-13,0,0,18,-6,18,-6,0,0,199,199,199,9.997116217,12.49639527,-2.499279054,0,-1.15351341,-1.15351341
50,2,4,46,79,South Dakota,Lake County,11059,11010,10851,-49,-159,39,122,21,120,18,2,0,0,-67,-159,-67,-159,0,-2,671,671,671,11.16142903,10.97845478,0.182974246,0,-14.54645259,-14.54645259
50,2,4,46,81,South Dakota,Lawrence County,25768,25812,26165,44,353,58,208,76,267,-18,-59,-1,36,64,379,63,415,-1,-3,1001,1001,1001,8.003540027,10.27377494,-2.270234912,1.385228082,14.58337342,15.9686015
50,2,4,46,83,South Dakota,Lincoln County,65161,65613,67870,452,2257,227,746,96,351,131,395,1,7,316,1871,317,1878,4,-16,265,265,265,11.17745331,5.259096664,5.918356645,0.10488227,28.03353236,28.13841463
50,2,4,46,85,South Dakota,Lyman County,3718,3714,3764,-4,50,16,57,10,30,6,27,0,0,-10,23,-10,23,0,0,37,37,37,15.24471784,8.023535705,7.221182134,0,6.151377374,6.151377374
50,2,4,46,87,South Dakota,McCook County,5682,5661,5695,-21,34,20,75,24,88,-4,-13,0,2,-17,44,-17,46,0,1,304,304,304,13.20887637,15.49841494,-2.28953857,0.352236703,7.749207467,8.101444171
50,2,4,46,89,South Dakota,McPherson County,2411,2397,2420,-14,23,5,26,13,30,-8,-4,0,0,-5,26,-5,26,-1,1,343,343,343,10.79510069,12.45588541,-1.660784721,0,10.79510069,10.79510069
50,2,4,46,91,South Dakota,Marshall County,4306,4300,4304,-6,4,12,62,6,51,6,11,0,2,-11,-10,-11,-8,-1,1,238,238,238,14.41190144,11.85495119,2.556950256,0.464900047,-2.324500232,-1.859600186
50,2,4,46,93,South Dakota,Meade County,29852,29853,30173,1,320,64,242,80,266,-16,-24,0,11,17,332,17,343,0,1,820,820,820,8.063172625,8.862826109,-0.799653483,0.366507847,11.06187319,11.42838104
50,2,4,46,95,South Dakota,Mellette County,1918,1916,1908,-2,-8,5,27,10,17,-5,10,0,0,4,-18,4,-18,-1,0,38,38,38,14.12133891,8.891213389,5.230125523,0,-9.414225941,-9.414225941
50,2,4,46,97,South Dakota,Miner County,2298,2294,2314,-4,20,7,26,6,31,1,-5,0,0,-5,25,-5,25,0,0,78,78,78,11.28472222,13.45486111,-2.170138889,0,10.85069444,10.85069444
50,2,4,46,99,South Dakota,Minnehaha County,197214,197511,199685,297,2174,702,2720,529,1780,173,940,25,482,92,719,117,1201,7,33,6127,6127,6127,13.69600902,8.962829434,4.733179589,2.427013364,3.620378856,6.04739222
50,2,4,46,101,South Dakota,Moody County,6336,6324,6315,-12,-9,21,78,18,57,3,21,0,1,-15,-31,-15,-30,0,0,84,84,84,12.34274864,9.019700926,3.32304771,0.158240367,-4.905451381,-4.747211014
50,2,4,46,102,South Dakota,Oglala Lakota County,13672,13672,13586,0,-86,72,241,29,192,43,49,0,0,-45,-137,-45,-137,2,2,55,55,55,17.68288209,14.08760731,3.595274782,0,-10.0520948,-10.0520948
50,2,4,46,103,South Dakota,Pennington County,109222,109475,111806,253,2331,350,1423,309,1203,41,220,2,79,212,2047,214,2126,-2,-15,2230,2230,2230,12.86147478,10.87305282,1.988421961,0.71402425,18.50136252,19.21538677
50,2,4,46,105,South Dakota,Perkins County,2835,2824,2819,-11,-5,5,33,11,38,-6,-5,0,0,-4,-1,-4,-1,-1,1,59,59,59,11.69590643,13.46801347,-1.772107035,0,-0.354421407,-0.354421407
50,2,4,46,107,South Dakota,Potter County,2472,2471,2475,-1,4,4,24,9,31,-5,-7,0,1,5,11,5,12,-1,-1,64,64,64,9.704811969,12.53538213,-2.830570158,0.404367165,4.448038819,4.852405985
50,2,4,46,109,South Dakota,Roberts County,10280,10257,10163,-23,-94,39,142,32,137,7,5,0,0,-30,-99,-30,-99,0,0,200,200,200,13.9079334,13.41821743,0.489715965,0,-9.696376102,-9.696376102
50,2,4,46,111,South Dakota,Sanborn County,2330,2318,2378,-12,60,7,30,9,17,-2,13,0,1,-10,46,-10,47,0,0,171,171,171,12.77683135,7.240204429,5.536626917,0.425894378,19.5911414,20.01703578
50,2,4,46,115,South Dakota,Spink County,6361,6338,6269,-23,-69,24,68,23,77,1,-9,0,0,-25,-59,-25,-59,1,-1,382,382,382,10.78765765,12.21543587,-1.427778218,0,-9.359879432,-9.359879432
50,2,4,46,117,South Dakota,Stanley County,2980,2976,3032,-4,56,7,26,4,21,3,5,0,0,-7,53,-7,53,0,-2,0,0,0,8.655126498,6.990679095,1.664447404,0,17.64314248,17.64314248
50,2,4,46,119,South Dakota,Sully County,1446,1446,1476,0,30,1,19,4,6,-3,13,0,0,2,17,2,17,1,0,0,0,0,13.00479124,4.106776181,8.898015058,0,11.63586585,11.63586585
50,2,4,46,121,South Dakota,Todd County,9319,9319,9286,0,-33,50,219,24,150,26,69,3,8,-31,-109,-28,-101,2,-1,14,14,14,23.54205859,16.12469766,7.417360925,0.859983875,-11.7172803,-10.85729643
50,2,4,46,123,South Dakota,Tripp County,5624,5601,5569,-23,-32,23,72,29,78,-6,-6,0,6,-16,-33,-16,-27,-1,1,128,128,128,12.89167413,13.9659803,-1.074306177,1.074306177,-5.908683975,-4.834377798
50,2,4,46,125,South Dakota,Turner County,8673,8673,8708,0,35,17,82,30,94,-13,-12,0,5,14,44,14,49,-1,-2,145,145,145,9.435590587,10.81640872,-1.380818135,0.57534089,5.062999827,5.638340717
50,2,4,46,127,South Dakota,Union County,16811,16832,16872,21,40,41,195,46,156,-5,39,3,11,23,-13,26,-2,0,3,84,84,84,11.57132685,9.257061476,2.314265369,0.652741514,-0.77142179,-0.118680275
50,2,4,46,129,South Dakota,Walworth County,5315,5289,5248,-26,-41,13,58,13,68,0,-10,0,0,-26,-31,-26,-31,0,0,126,126,126,11.00882604,12.9068995,-1.898073455,0,-5.884027712,-5.884027712
50,2,4,46,135,South Dakota,Yankton County,23310,23238,23297,-72,59,54,262,89,272,-35,-10,-1,11,-34,54,-35,65,-2,4,2270,2270,2270,11.26034168,11.69012571,-0.429784034,0.472762437,2.320833781,2.793596218
50,2,4,46,137,South Dakota,Ziebach County,2413,2388,2380,-25,-8,14,26,7,36,7,-10,0,0,-32,2,-32,2,0,0,0,0,0,10.90604027,15.10067114,-4.194630872,0,0.838926175,0.838926175
40,3,6,47,0,Tennessee,Tennessee,6910840,6920119,6975218,9279,55099,19055,77353,21873,84944,-2818,-7591,36,1751,12082,61390,12118,63141,-21,-451,150258,150258,150258,11.13366304,12.22625979,-1.092596747,0.252026993,8.836057737,9.088084729
50,3,6,47,1,Tennessee,Anderson County,77123,77209,77576,86,367,173,772,278,1085,-105,-313,0,14,196,663,196,677,-5,3,1090,1090,1090,9.975126789,14.01944633,-4.04431954,0.180896082,8.566721582,8.747617663
50,3,6,47,3,Tennessee,Bedford County,50237,50302,51119,65,817,160,675,172,573,-12,102,1,20,75,696,76,716,1,-1,452,452,452,13.31085278,11.29943503,2.011417754,0.394395638,13.7249682,14.11936384
50,3,6,47,5,Tennessee,Benton County,15864,15812,15872,-52,60,33,157,93,312,-60,-155,0,0,11,216,11,216,-3,-1,182,182,182,9.910364853,19.69448302,-9.784118167,0,13.63464209,13.63464209
50,3,6,47,7,Tennessee,Bledsoe County,14913,14930,15234,17,304,28,128,44,186,-16,-58,0,6,33,358,33,364,0,-2,2681,2681,2681,8.486938072,12.33258189,-3.845643814,0.397825222,23.73690492,24.13473014
50,3,6,47,9,Tennessee,Blount County,135280,135566,137605,286,2039,310,1206,432,1728,-122,-522,0,24,415,2558,415,2582,-7,-21,1928,1928,1928,8.829634185,12.65141615,-3.821781961,0.175714113,18.72819589,18.90391001
50,3,6,47,11,Tennessee,Bradley County,108620,108741,110162,121,1421,295,1123,379,1360,-84,-237,0,33,207,1631,207,1664,-2,-6,2395,2395,2395,10.26025226,12.4255949,-2.16534264,0.301503406,14.90157741,15.20308082
50,3,6,47,13,Tennessee,Campbell County,39272,39277,39578,5,301,110,448,153,678,-43,-230,0,6,50,527,50,533,-2,-2,576,576,576,11.36262761,17.19611946,-5.833491852,0.152178048,13.36630524,13.51848329
50,3,6,47,15,Tennessee,Cannon County,14506,14547,14553,41,6,40,164,62,202,-22,-38,0,1,64,42,64,43,-1,1,93,93,93,11.27147766,13.88316151,-2.611683849,0.068728522,2.886597938,2.955326461
50,3,6,47,17,Tennessee,Carroll County,28440,28415,28432,-25,17,73,321,139,477,-66,-156,0,0,43,171,43,171,-2,2,1186,1186,1186,11.29347195,16.78188823,-5.488416275,0,6.016148609,6.016148609
50,3,6,47,19,Tennessee,Carter County,56356,56315,56134,-41,-181,101,435,229,937,-128,-502,0,4,93,312,93,316,-6,5,956,956,956,7.736840701,16.66533273,-8.928492027,0.071143363,5.549182296,5.620325659
50,3,6,47,21,Tennessee,Cheatham County,41072,41087,41523,15,436,95,451,147,496,-52,-45,1,12,65,466,66,478,1,3,228,228,228,10.91877497,12.00823145,-1.089456482,0.290521729,11.28192713,11.57244886
50,3,6,47,23,Tennessee,Chester County,17341,17347,17504,6,157,34,173,59,198,-25,-25,-1,-2,33,185,32,183,-1,-1,1087,1087,1087,9.927979111,11.36265817,-1.434679062,-0.114774325,10.61662506,10.50185074
50,3,6,47,25,Tennessee,Claiborne County,32043,32038,32267,-5,229,62,320,128,518,-66,-198,0,4,63,426,63,430,-2,-3,1194,1194,1194,9.952569785,16.11072234,-6.158152554,0.124407122,13.24935853,13.37376565
50,3,6,47,27,Tennessee,Clay County,7581,7554,7555,-27,1,15,74,61,149,-46,-75,0,3,20,74,20,77,-1,-1,56,56,56,9.795486134,19.7233437,-9.927857568,0.397114303,9.795486134,10.19260044
50,3,6,47,29,Tennessee,Cocke County,35999,36022,36418,23,396,83,332,156,669,-73,-337,0,0,99,738,99,738,-3,-5,322,322,322,9.166206516,18.47045831,-9.304251795,0,20.37548316,20.37548316
50,3,6,47,31,Tennessee,Coffee County,57889,58102,59032,213,930,192,691,210,808,-18,-117,4,27,227,1026,231,1053,0,-6,536,536,536,11.79845305,13.79616508,-1.997712022,0.461010467,17.51839773,17.9794082
50,3,6,47,33,Tennessee,Crockett County,13911,13884,13979,-27,95,47,167,75,221,-28,-54,0,2,1,146,1,148,0,1,145,145,145,11.9872232,15.8633313,-3.8761081,0.143559559,10.47984783,10.62340739
50,3,6,47,35,Tennessee,Cumberland County,61145,61272,62451,127,1179,112,486,275,1074,-163,-588,0,8,302,1780,302,1788,-12,-21,563,563,563,7.856259548,17.36136369,-9.505104144,0.129321145,28.77395472,28.90327587
50,3,6,47,37,Tennessee,Davidson County,715884,715486,703953,-398,-11533,2291,9614,1720,6795,571,2819,34,594,-1026,-14770,-992,-14176,23,-176,25939,25939,25939,13.54619677,9.57420502,3.971991752,0.836950373,-20.81103873,-19.97408835
50,3,6,47,39,Tennessee,Decatur County,11435,11402,11391,-33,-11,25,103,75,215,-50,-112,0,0,18,101,18,101,-1,0,166,166,166,9.037862502,18.86544114,-9.827578643,0,8.862370026,8.862370026
50,3,6,47,41,Tennessee,DeKalb County,20080,20171,20478,91,307,60,245,78,321,-18,-76,0,18,110,369,110,387,-1,-4,165,165,165,12.05441708,15.79374646,-3.739329381,0.885630643,18.15542818,19.04105882
50,3,6,47,43,Tennessee,Dickson County,54315,54432,55292,117,860,152,610,157,664,-5,-54,0,5,122,911,122,916,0,-2,601,601,601,11.11880719,12.10309504,-0.98428785,0.091137764,16.60530057,16.69643834
50,3,6,47,45,Tennessee,Dyer County,36801,36646,36615,-155,-31,104,455,170,565,-66,-110,0,-1,-88,73,-88,72,-1,7,426,426,426,12.42134287,15.42430488,-3.002962013,-0.027299655,1.99287479,1.965575136
50,3,6,47,47,Tennessee,Fayette County,41990,42139,42832,149,693,99,376,121,582,-22,-206,0,-1,172,906,172,905,-1,-6,392,392,392,8.850078262,13.69879135,-4.84871309,-0.023537442,21.32492262,21.30138518
50,3,6,47,49,Tennessee,Fentress County,18489,18522,18850,33,328,44,160,86,324,-42,-164,0,2,76,495,76,497,-1,-5,214,214,214,8.562560206,17.33918442,-8.776624211,0.107032003,26.49042064,26.59745264
50,3,6,47,51,Tennessee,Franklin County,42774,42781,43215,7,434,87,408,163,617,-76,-209,1,8,84,640,85,648,-2,-5,2150,2150,2150,9.488813433,14.34950463,-4.860691195,0.186055165,14.88441323,15.07046839
50,3,6,47,53,Tennessee,Gibson County,50429,50375,50541,-54,166,125,517,230,823,-105,-306,0,10,53,458,53,468,-2,4,1092,1092,1092,10.24614531,16.31059495,-6.064449641,0.198184629,9.076855999,9.275040628
50,3,6,47,55,Tennessee,Giles County,30346,30295,30542,-51,247,63,312,149,456,-86,-144,0,18,36,375,36,393,-1,-2,632,632,632,10.25691602,14.99087726,-4.733961241,0.591745155,12.32802406,12.91976922
50,3,6,47,57,Tennessee,Grainger County,23527,23525,23763,-2,238,49,219,104,390,-55,-171,0,3,55,408,55,411,-2,-2,118,118,118,9.26239215,16.49467095,-7.232278802,0.126882084,17.25596346,17.38284554
50,3,6,47,59,Tennessee,Greene County,70152,70220,70621,68,401,141,624,282,1138,-141,-514,-1,6,214,912,213,918,-4,-3,1622,1622,1622,8.861056085,16.16006703,-7.299010941,0.085202462,12.95077428,13.03597674
50,3,6,47,61,Tennessee,Grundy County,13529,13531,13622,2,91,44,162,75,214,-31,-52,0,0,34,144,34,144,-1,-1,157,157,157,11.93238316,15.76253084,-3.830147682,0,10.60656281,10.60656281
50,3,6,47,63,Tennessee,Hamblen County,64499,64435,64468,-64,33,156,727,289,947,-133,-220,0,7,72,238,72,245,-3,8,868,868,868,11.27979954,14.69321893,-3.413419393,0.108608799,3.692699161,3.80130796
50,3,6,47,65,Tennessee,Hamilton County,366207,366991,369135,784,2144,1063,4114,1105,4456,-42,-342,-2,74,831,2369,829,2443,-3,43,9485,9485,9485,11.1774343,12.10662305,-0.929188753,0.201052537,6.436398117,6.637450654
50,3,6,47,67,Tennessee,Hancock County,6662,6622,6787,-40,165,11,65,30,111,-19,-46,0,0,-20,214,-20,214,-1,-3,145,145,145,9.694980983,16.55604445,-6.861063465,0,31.91886047,31.91886047
50,3,6,47,69,Tennessee,Hardeman County,25462,25410,25426,-52,16,60,243,90,356,-30,-113,0,0,-22,127,-22,127,0,2,3861,3861,3861,9.560154221,14.00582265,-4.445668424,0,4.996459202,4.996459202
50,3,6,47,71,Tennessee,Hardin County,26831,26800,26892,-31,92,44,231,105,458,-61,-227,0,0,33,321,33,321,-3,-2,360,360,360,8.604633837,17.06026969,-8.455635849,0,11.95708858,11.95708858
50,3,6,47,73,Tennessee,Hawkins County,56721,56669,57288,-52,619,121,488,216,929,-95,-441,0,4,48,1067,48,1071,-5,-11,500,500,500,8.564634029,16.30439552,-7.739761489,0.070201918,18.7263617,18.79656362
50,3,6,47,75,Tennessee,Haywood County,17864,17795,17694,-69,-101,49,172,75,252,-26,-80,0,3,-41,-27,-41,-24,-2,3,192,192,192,9.693144355,14.20158359,-4.508439235,0.169066471,-1.521598242,-1.35253177
50,3,6,47,77,Tennessee,Henderson County,27842,27818,27953,-24,135,82,296,131,399,-49,-103,0,-1,26,239,26,238,-1,0,311,311,311,10.61483567,14.30851159,-3.693675925,-0.035860931,8.570762583,8.534901651
50,3,6,47,79,Tennessee,Henry County,32199,32115,32239,-84,124,77,306,150,578,-73,-272,0,0,-8,398,-8,398,-3,-2,430,430,430,9.509898375,17.96314137,-8.453243,0,12.36908351,12.36908351
50,3,6,47,81,Tennessee,Hickman County,24925,24942,25307,17,365,56,248,115,363,-59,-115,0,-1,75,485,75,484,1,-4,1362,1362,1362,9.870843201,14.44804872,-4.577205517,-0.039801787,19.30386674,19.26406496
50,3,6,47,83,Tennessee,Houston County,8283,8285,8317,2,32,16,81,42,138,-26,-57,0,-1,29,88,29,87,-1,2,146,146,146,9.757860499,16.62450307,-6.866642573,-0.120467414,10.60113239,10.48066498
50,3,6,47,85,Tennessee,Humphreys County,18990,18974,19211,-16,237,44,209,74,275,-30,-66,0,0,16,305,16,305,-2,-2,238,238,238,10.94670682,14.40356161,-3.456854786,0,15.97485924,15.97485924
50,3,6,47,87,Tennessee,Jackson County,11617,11617,11750,0,133,24,81,55,203,-31,-122,0,0,32,258,32,258,-1,-3,110,110,110,6.932854025,17.37493046,-10.44207643,0,22.08242393,22.08242393
50,3,6,47,89,Tennessee,Jefferson County,54683,54870,55624,187,754,137,476,204,843,-67,-367,0,6,256,1128,256,1134,-2,-13,1348,1348,1348,8.615852445,15.25874708,-6.642894637,0.108603182,20.41739823,20.52600141
50,3,6,47,91,Tennessee,Johnson County,17948,17966,18170,18,204,34,147,75,290,-41,-143,0,4,62,345,62,349,-3,-2,1615,1615,1615,8.135930928,16.05047598,-7.914545052,0.221385876,19.09453177,19.31591764
50,3,6,47,93,Tennessee,Knox County,478971,480126,486677,1155,6551,1283,4975,1401,5541,-118,-566,0,106,1267,7029,1267,7135,6,-18,12239,12239,12239,10.29165197,11.46252132,-1.17086935,0.219279419,14.54070788,14.7599873
50,3,6,47,95,Tennessee,Lake County,7005,6980,7128,-25,148,9,54,26,101,-17,-47,0,0,-8,197,-8,197,0,-2,2189,2189,2189,7.655231075,14.31811738,-6.662886306,0,27.92741707,27.92741707
50,3,6,47,97,Tennessee,Lauderdale County,25143,25100,25108,-43,8,68,272,81,340,-13,-68,0,-2,-29,73,-29,71,-1,5,2030,2030,2030,10.83492671,13.54365838,-2.708731676,-0.079668579,2.907903123,2.828234544
50,3,6,47,99,Tennessee,Lawrence County,44159,44189,44828,30,639,134,515,173,671,-39,-156,0,0,70,802,70,802,-1,-7,466,466,466,11.57082355,15.07577204,-3.504948493,0,18.01903007,18.01903007
50,3,6,47,101,Tennessee,Lewis County,12582,12602,12857,20,255,37,117,48,181,-11,-64,0,4,31,322,31,326,0,-7,189,189,189,9.191248674,14.21894026,-5.027691583,0.314230724,25.29557328,25.609804
50,3,6,47,103,Tennessee,Lincoln County,35319,35309,35433,-10,124,87,346,138,529,-51,-183,1,5,43,301,44,306,-3,1,259,259,259,9.782024823,14.95575471,-5.173729892,0.14135874,8.509796161,8.651154901
50,3,6,47,105,Tennessee,Loudon County,54886,55097,56690,211,1593,132,509,190,743,-58,-234,2,21,274,1829,276,1850,-7,-23,410,410,410,9.106604525,13.29313784,-4.186533318,0.375714529,32.72294632,33.09866085
50,3,6,47,107,Tennessee,McMinn County,53276,53315,54059,39,744,150,580,231,850,-81,-270,0,12,124,1010,124,1022,-4,-8,934,934,934,10.80336022,15.83251066,-5.029150446,0.223517798,18.81274797,19.03626576
50,3,6,47,109,Tennessee,McNairy County,25866,25839,25860,-27,21,57,292,127,428,-70,-136,0,2,45,154,45,156,-2,1,271,271,271,11.2961566,16.55738022,-5.261223621,0.077370936,5.957562042,6.034932977
50,3,6,47,111,Tennessee,Macon County,25216,25243,25699,27,456,83,301,100,344,-17,-43,0,0,44,504,44,504,0,-5,306,306,306,11.81736092,13.50555534,-1.688194417,0,19.78720898,19.78720898
50,3,6,47,113,Tennessee,Madison County,98823,98777,98775,-46,-2,327,1175,383,1250,-56,-75,1,25,13,27,14,52,-4,21,4435,4435,4435,11.89560217,12.65489593,-0.759293756,0.253097919,0.273345752,0.526443671
50,3,6,47,115,Tennessee,Marion County,28837,28834,28877,-3,43,80,279,118,439,-38,-160,0,1,36,200,36,201,-1,2,218,218,218,9.668867287,15.21373742,-5.544870129,0.034655438,6.931087661,6.965743099
50,3,6,47,117,Tennessee,Marshall County,34318,34441,34984,123,543,105,392,94,457,11,-65,-1,12,111,600,110,612,2,-4,280,280,280,11.29276197,13.16528628,-1.872524307,0.345696795,17.28483976,17.63053655
50,3,6,47,119,Tennessee,Maury County,100974,101700,104760,726,3060,336,1229,298,1181,38,48,-1,-7,685,3050,684,3043,4,-31,945,945,945,11.90545384,11.44047273,0.46498111,-0.067809745,29.54567471,29.47786496
50,3,6,47,121,Tennessee,Meigs County,12758,12785,13049,27,264,24,126,57,180,-33,-54,0,0,61,323,61,323,-1,-5,130,130,130,9.754586978,13.93512426,-4.180537276,0,25.0058063,25.0058063
50,3,6,47,123,Tennessee,Monroe County,46250,46384,46698,134,314,130,488,157,730,-27,-242,0,2,164,553,164,555,-3,1,420,420,420,10.48537848,15.68509486,-5.199716379,0.042972863,11.88199652,11.92496938
50,3,6,47,125,Tennessee,Montgomery County,220069,221160,227900,1091,6740,880,3407,457,1805,423,1602,-7,-48,648,5224,641,5176,27,-38,3700,3700,3700,15.17391885,8.039014831,7.134904022,-0.213779896,23.26637866,23.05259876
50,3,6,47,127,Tennessee,Moore County,6461,6457,6644,-4,187,13,63,16,90,-3,-27,0,2,0,215,0,217,-1,-3,80,80,80,9.617586444,13.73940921,-4.121822762,0.305320205,32.82192199,33.1272422
50,3,6,47,129,Tennessee,Morgan County,21035,21020,21254,-15,234,39,171,82,264,-43,-93,0,0,29,327,29,327,-1,0,2174,2174,2174,8.090079008,12.48994654,-4.399867531,0,15.47050196,15.47050196
50,3,6,47,131,Tennessee,Obion County,30787,30716,30466,-71,-250,62,323,121,519,-59,-196,0,6,-10,-65,-10,-59,-2,5,425,425,425,10.55866104,16.96577425,-6.407113203,0.196136119,-2.12480795,-1.928671832
50,3,6,47,133,Tennessee,Overton County,22511,22588,22839,77,251,64,239,81,421,-17,-182,0,0,95,436,95,436,-1,-3,227,227,227,10.52237656,18.53523235,-8.012855791,0,19.19563255,19.19563255
50,3,6,47,135,Tennessee,Perry County,8366,8360,8472,-6,112,22,102,29,124,-7,-22,0,0,1,135,1,135,0,-1,124,124,124,12.11977186,14.7338403,-2.614068441,0,16.04087453,16.04087453
50,3,6,47,137,Tennessee,Pickett County,5001,4995,5079,-6,84,5,38,14,83,-9,-45,0,0,4,130,4,130,-1,-1,39,39,39,7.544173119,16.47806234,-8.93388922,0,25.8090133,25.8090133
50,3,6,47,139,Tennessee,Polk County,17544,17569,17776,25,207,35,150,54,302,-19,-152,0,1,44,362,44,363,0,-4,268,268,268,8.487763474,17.08869713,-8.600933654,0.05658509,20.48380252,20.54038761
50,3,6,47,141,Tennessee,Putnam County,79854,79982,81188,128,1206,181,862,283,1034,-102,-172,0,17,229,1368,229,1385,1,-7,2347,2347,2347,10.6967798,12.83117205,-2.134392257,0.210957374,16.975864,17.18682137
50,3,6,47,143,Tennessee,Rhea County,32870,32903,33136,33,233,81,364,113,506,-32,-142,0,7,66,367,66,374,-1,1,720,720,720,11.02378897,15.32427808,-4.300489105,0.211995942,11.11464438,11.32664032
50,3,6,47,145,Tennessee,Roane County,53404,53513,53992,109,479,120,443,208,908,-88,-465,0,-8,202,961,202,953,-5,-9,635,635,635,8.241477141,16.89223757,-8.65076043,-0.148830287,17.87823822,17.72940794
50,3,6,47,147,Tennessee,Robertson County,72803,72860,74098,57,1238,187,859,242,876,-55,-17,0,39,111,1224,111,1263,1,-8,840,840,840,11.69041495,11.92177357,-0.231358619,0.530763892,16.6578206,17.18858449
50,3,6,47,149,Tennessee,Rutherford County,341486,343128,352182,1642,9054,1010,4056,684,2681,326,1375,-5,126,1292,7614,1287,7740,29,-61,5009,5009,5009,11.66673858,7.711668177,3.9550704,0.362428269,21.90102257,22.26345084
50,3,6,47,151,Tennessee,Scott County,21850,21842,21917,-8,75,56,246,67,307,-11,-61,0,-1,4,134,4,133,-1,3,235,235,235,11.24340136,14.03139926,-2.787997898,-0.045704884,6.124454398,6.078749514
50,3,6,47,153,Tennessee,Sequatchie County,15826,15863,16396,37,533,41,143,33,229,8,-86,0,1,30,628,30,629,-1,-10,183,183,183,8.865742894,14.19758827,-5.331845376,0.061998202,38.93487089,38.99686909
50,3,6,47,155,Tennessee,Sevier County,98380,98497,99517,117,1020,252,1004,307,1294,-55,-290,-2,44,180,1269,178,1313,-6,-3,1053,1053,1053,10.14069712,13.06978295,-2.929085822,0.444413021,12.81727555,13.26168857
50,3,6,47,157,Tennessee,Shelby County,929744,928644,924454,-1100,-4190,2994,12243,2811,10668,183,1575,8,244,-1320,-6132,-1312,-5888,29,123,16823,16823,16823,13.21354834,11.51369221,1.699856133,0.263342791,-6.618106544,-6.354763752
50,3,6,47,159,Tennessee,Smith County,19904,19939,20172,35,233,53,203,67,266,-14,-63,-1,1,50,297,49,298,0,-2,172,172,172,10.1219117,13.26319464,-3.14128294,0.049861634,14.80890529,14.85876692
50,3,6,47,161,Tennessee,Stewart County,13657,13683,13855,26,172,40,142,64,194,-24,-52,0,0,51,227,51,227,-1,-3,116,116,116,10.31302201,14.08962161,-3.776599608,0,16.48630983,16.48630983
50,3,6,47,163,Tennessee,Sullivan County,158163,158092,159265,-71,1173,336,1398,650,2475,-314,-1077,-1,4,256,2257,255,2261,-12,-11,2562,2562,2562,8.810267302,15.59757623,-6.78730893,0.025208204,14.22372911,14.24893732
50,3,6,47,165,Tennessee,Sumner County,196281,197272,200557,991,3285,519,2098,500,2197,19,-99,1,33,967,3369,968,3402,4,-18,1319,1319,1319,10.54724517,11.04494645,-0.497701274,0.165900425,16.93692516,17.10282559
50,3,6,47,167,Tennessee,Tipton County,60970,60961,61004,-9,43,146,657,201,742,-55,-85,0,2,45,112,45,114,1,14,876,876,876,10.77358259,12.16742508,-1.393842496,0.032796294,1.836592465,1.869388759
50,3,6,47,169,Tennessee,Trousdale County,11615,11661,12035,46,374,30,119,21,134,9,-15,0,-1,37,394,37,393,0,-4,2656,2656,2656,10.04388926,11.30992573,-1.266036462,-0.084402431,33.25455773,33.1701553
50,3,6,47,171,Tennessee,Unicoi County,17928,17867,17698,-61,-169,26,132,74,337,-48,-205,1,9,-12,24,-11,33,-2,3,405,405,405,7.423028258,18.95121608,-11.52818783,0.506115563,1.349641502,1.855757065
50,3,6,47,173,Tennessee,Union County,19802,19820,20040,18,220,42,188,94,290,-52,-102,0,1,70,324,70,325,0,-3,117,117,117,9.433015554,14.55092825,-5.117912694,0.050175615,16.25689915,16.30707476
50,3,6,47,175,Tennessee,Van Buren County,6168,6171,6324,3,153,18,56,31,72,-13,-16,0,0,16,172,16,172,0,-3,134,134,134,8.963585434,11.52460984,-2.56102441,0,27.53101241,27.53101241
50,3,6,47,177,Tennessee,Warren County,40953,41023,41523,70,500,114,459,132,591,-18,-132,2,21,87,614,89,635,-1,-3,426,426,426,11.12107189,14.31928864,-3.198216752,0.508807211,14.87655368,15.38536089
50,3,6,47,179,Tennessee,Washington County,133001,133080,134236,79,1156,270,1203,468,1731,-198,-528,-1,33,283,1647,282,1680,-5,4,4031,4031,4031,9.000583579,12.9509644,-3.950380823,0.246898801,12.32249473,12.56939353
50,3,6,47,181,Tennessee,Wayne County,16232,16202,16409,-30,207,39,134,63,236,-24,-102,0,0,-6,313,-6,313,0,-4,2127,2127,2127,8.218085922,14.47364386,-6.255557941,0,19.19597682,19.19597682
50,3,6,47,183,Tennessee,Weakley County,32902,32864,33036,-38,172,74,321,119,440,-45,-119,0,13,10,275,10,288,-3,3,1512,1512,1512,9.742033384,13.35356601,-3.611532625,0.394537178,8.345978756,8.740515933
50,3,6,47,185,Tennessee,White County,27351,27424,27650,73,226,74,294,100,444,-26,-150,0,2,101,375,101,377,-2,-1,324,324,324,10.67654429,16.12376076,-5.447216472,0.072629553,13.61804118,13.69067073
50,3,6,47,187,Tennessee,Williamson County,247726,249424,255735,1698,6311,536,2202,378,1791,158,411,0,64,1529,5900,1529,5964,11,-64,1086,1086,1086,8.718047189,7.090836747,1.627210443,0.253385568,23.35898202,23.61236759
50,3,6,47,189,Tennessee,Wilson County,147737,148564,151917,827,3353,433,1572,429,1555,4,17,2,39,816,3327,818,3366,5,-30,1477,1477,1477,10.46322396,10.35007205,0.113151913,0.259583801,22.14449499,22.40407879
40,3,7,48,0,Texas,Texas,29145505,29217653,29527941,72148,310288,88377,362450,60137,248605,28240,113845,1318,27185,40982,170307,42300,197492,1608,-1049,562170,562170,562170,12.33964883,8.463783684,3.875865142,0.925516218,5.798119941,6.723636159
50,3,7,48,1,Texas,Anderson County,57922,57881,58402,-41,521,145,532,205,757,-60,-225,0,29,18,716,18,745,1,1,14307,14307,14307,9.150090727,13.01995993,-3.869869198,0.498783141,12.31478376,12.8135669
50,3,7,48,3,Texas,Andrews County,18610,18612,18440,2,-172,68,290,25,129,43,161,0,15,-43,-347,-43,-332,2,-1,47,47,47,15.65367592,6.963186873,8.690489042,0.809672892,-18.73043291,-17.92076001
50,3,7,48,5,Texas,Angelina County,86395,86345,86506,-50,161,249,1023,281,1085,-32,-62,0,11,-17,195,-17,206,-1,17,2401,2401,2401,11.83678428,12.55416515,-0.717380866,0.12727725,2.256278529,2.383555779
50,3,7,48,7,Texas,Aransas County,23830,23916,24510,86,594,48,175,116,421,-68,-246,0,5,158,849,158,854,-4,-14,376,376,376,7.227522405,17.3873539,-10.1598315,0.20650064,35.0638087,35.27030934
50,3,7,48,9,Texas,Archer County,8560,8557,8681,-3,124,23,83,32,113,-9,-30,0,3,7,153,7,156,-1,-2,28,28,28,9.629887458,13.11056967,-3.480682214,0.348068221,17.75147929,18.09954751
50,3,7,48,11,Texas,Armstrong County,1848,1847,1839,-1,-8,4,11,12,23,-8,-12,0,0,7,4,7,4,0,0,36,36,36,5.968529571,12.47965274,-6.511123169,0,2.17037439,2.17037439
50,3,7,48,13,Texas,Atascosa County,48981,49089,49939,108,850,153,639,128,534,25,105,0,0,81,748,81,748,2,-3,164,164,164,12.90544089,10.78482853,2.120612352,0,15.10683847,15.10683847
50,3,7,48,15,Texas,Austin County,30167,30109,30380,-58,271,83,336,98,369,-15,-33,-1,5,-38,297,-39,302,-4,2,167,167,167,11.10945792,12.20056539,-1.091107474,0.165319314,9.819967267,9.985286581
50,3,7,48,17,Texas,Bailey County,6904,6859,6835,-45,-24,38,136,24,50,14,86,0,0,-59,-110,-59,-110,0,0,88,88,88,19.8627136,7.302468234,12.56024536,0,-16.06543012,-16.06543012
50,3,7,48,19,Texas,Bandera County,20851,20987,21565,136,578,46,174,78,321,-32,-147,0,4,170,732,170,736,-2,-11,134,134,134,8.17822899,15.08742245,-6.909193457,0.188005264,34.40496334,34.5929686
50,3,7,48,21,Texas,Bastrop County,97216,97983,102058,767,4075,248,1063,194,923,54,140,0,-14,710,4013,710,3999,3,-64,2342,2342,2342,10.6278213,9.228108238,1.399713059,-0.139971306,40.12177504,39.98180373
50,3,7,48,23,Texas,Baylor County,3465,3464,3477,-1,13,10,43,11,62,-1,-19,0,2,0,30,0,32,0,0,48,48,48,12.39014551,17.86486097,-5.474715459,0.576285838,8.644287567,9.220573404
50,3,7,48,25,Texas,Bee County,31047,30990,30924,-57,-66,69,302,80,303,-11,-1,0,12,-48,-81,-48,-69,2,4,7303,7303,7303,9.755467261,9.787770133,-0.032302872,0.387634461,-2.61653261,-2.228898149
50,3,7,48,27,Texas,Bell County,370647,371981,379617,1334,7636,1391,5885,715,2996,676,2889,19,34,610,4695,629,4729,29,18,10106,10106,10106,15.65996716,7.97234692,7.687620244,0.090473897,12.49338077,12.58385467
50,3,7,48,29,Texas,Bexar County,2009324,2014052,2028236,4728,14184,6137,25078,4255,16973,1882,8105,73,911,2657,4687,2730,5598,116,481,40867,40867,40867,12.40782448,8.397719311,4.010105168,0.450734831,2.318983704,2.769718536
50,3,7,48,31,Texas,Blanco County,11374,11454,11886,80,432,26,94,30,159,-4,-65,0,-1,84,505,84,504,0,-7,25,25,25,8.054841474,13.62467866,-5.569837189,-0.085689803,43.27335047,43.18766067
50,3,7,48,33,Texas,Borden County,631,641,617,10,-24,1,7,4,12,-3,-5,0,0,13,-19,13,-19,0,0,0,0,0,11.12877584,19.07790143,-7.949125596,0,-30.20667727,-30.20667727
50,3,7,48,35,Texas,Bosque County,18235,18239,18503,4,264,54,169,75,313,-21,-144,0,6,28,408,28,414,-3,-6,225,225,225,9.199281476,17.0377225,-7.838441021,0.326601709,22.20891623,22.53551794
50,3,7,48,37,Texas,Bowie County,92893,92792,92581,-101,-211,238,988,317,1208,-79,-220,2,8,-24,-18,-22,-10,0,19,5619,5619,5619,10.65958905,13.03318175,-2.373592702,0.086312462,-0.194203039,-0.107890577
50,3,7,48,39,Texas,Brazoria County,372031,373368,379689,1337,6321,1162,4541,754,3017,408,1524,4,76,904,4720,908,4796,21,1,9916,9916,9916,12.06017606,8.012673675,4.04750238,0.201843951,12.53557168,12.73741563
50,3,7,48,41,Texas,Brazos County,233849,234480,237032,631,2552,653,2552,304,1455,349,1097,19,371,242,1027,261,1398,21,57,14432,14432,14432,10.82475101,6.17163508,4.653115933,1.573660904,4.356198782,5.929859685
50,3,7,48,43,Texas,Brewster County,9546,9566,9450,20,-116,19,69,21,108,-2,-39,0,5,22,-79,22,-74,0,-3,42,42,42,7.257046698,11.3588557,-4.101809003,0.525872949,-8.308792596,-7.782919647
50,3,7,48,45,Texas,Briscoe County,1435,1421,1403,-14,-18,2,11,1,21,1,-10,0,0,-15,-8,-15,-8,0,0,0,0,0,7.790368272,14.87252125,-7.082152975,0,-5.66572238,-5.66572238
50,3,7,48,47,Texas,Brooks County,7076,7030,6994,-46,-36,22,98,20,91,2,7,0,9,-48,-53,-48,-44,0,1,41,41,41,13.97604107,12.97775242,0.998288648,1.283513976,-7.558471192,-6.274957216
50,3,7,48,49,Texas,Brown County,38095,38002,38192,-93,190,94,363,168,579,-74,-216,0,8,-17,397,-17,405,-2,1,1504,1504,1504,9.528309316,15.19804709,-5.669737775,0.209990288,10.42076804,10.63075833
50,3,7,48,51,Texas,Burleson County,17642,17644,18051,2,407,42,168,64,281,-22,-113,0,16,25,510,25,526,-1,-6,90,90,90,9.413083065,15.74450203,-6.331418966,0.896484101,28.57543073,29.47191483
50,3,7,48,53,Texas,Burnet County,49130,49427,50954,297,1527,85,471,152,654,-67,-183,0,-8,366,1743,366,1735,-2,-25,1037,1037,1037,9.384246023,13.03035435,-3.646108327,-0.159392714,34.72768751,34.5682948
50,3,7,48,55,Texas,Caldwell County,45883,45967,46791,84,824,118,587,86,476,32,111,1,13,50,705,51,718,1,-5,3401,3401,3401,12.65659027,10.2632657,2.393324565,0.280299273,15.20084521,15.48114448
50,3,7,48,57,Texas,Calhoun County,20106,20047,19727,-59,-320,73,256,63,247,10,9,0,11,-68,-336,-68,-325,-1,-4,127,127,127,12.87273093,12.42017398,0.452556947,0.553125157,-16.89545935,-16.34233419
50,3,7,48,59,Texas,Callahan County,13708,13750,14115,42,365,33,131,51,214,-18,-83,0,0,59,455,59,455,1,-7,48,48,48,9.402476225,15.35977032,-5.957294097,0,32.65745559,32.65745559
50,3,7,48,61,Texas,Cameron County,421017,421191,423029,174,1838,1401,5859,804,3462,597,2397,-3,-18,-436,-640,-439,-658,16,99,3123,3123,3123,13.88026818,8.201653597,5.678614579,-0.042642913,-1.516192462,-1.558835375
50,3,7,48,63,Texas,Camp County,12464,12450,12616,-14,166,41,144,34,183,7,-39,0,4,-21,204,-21,208,0,-3,29,29,29,11.48966728,14.60145217,-3.111784888,0.319157424,16.27702864,16.59618607
50,3,7,48,65,Texas,Carson County,5807,5808,5746,1,-62,12,44,15,70,-3,-26,0,0,4,-34,4,-34,0,-2,14,14,14,7.616409901,12.11701575,-4.500605851,0,-5.885407651,-5.885407651
50,3,7,48,67,Texas,Cass County,28454,28399,28560,-55,161,60,294,124,526,-64,-232,0,-2,12,398,12,396,-3,-3,210,210,210,10.32321494,18.46942538,-8.146210432,-0.070225952,13.97496445,13.9047385
50,3,7,48,69,Texas,Castro County,7371,7337,7374,-34,37,21,96,16,61,5,35,0,11,-39,-8,-39,3,0,-1,26,26,26,13.05145809,8.293113996,4.758344096,1.495479573,-1.087621508,0.407858065
50,3,7,48,71,Texas,Chambers County,46571,47051,48865,480,1814,128,626,68,344,60,282,-1,7,418,1546,417,1553,3,-21,202,202,202,13.05308812,7.172942992,5.880145127,0.145961049,32.23654031,32.38250136
50,3,7,48,73,Texas,Cherokee County,50412,50477,51097,65,620,177,665,157,652,20,13,0,10,46,596,46,606,-1,1,2421,2421,2421,13.09390198,12.83793097,0.255971016,0.196900782,11.73528659,11.93218737
50,3,7,48,75,Texas,Childress County,6664,6648,6736,-16,88,17,63,21,73,-4,-10,0,2,-12,95,-12,97,0,1,1528,1528,1528,9.414225941,10.90854752,-1.494321578,0.298864316,14.19605499,14.49491931
50,3,7,48,77,Texas,Clay County,10218,10245,10263,27,18,16,84,24,188,-8,-104,0,6,35,118,35,124,0,-2,42,42,42,8.191925102,18.33430856,-10.14238346,0.585137507,11.50770431,12.09284182
50,3,7,48,79,Texas,Cochran County,2547,2559,2516,12,-43,9,39,7,14,2,25,1,6,10,-74,11,-68,-1,0,36,36,36,15.36945813,5.517241379,9.852216749,2.36453202,-29.16256158,-26.79802956
50,3,7,48,81,Texas,Coke County,3285,3288,3321,3,33,9,39,15,57,-6,-18,0,0,10,50,10,50,-1,1,25,25,25,11.80208806,17.24920563,-5.447117567,0,15.13088213,15.13088213
50,3,7,48,83,Texas,Coleman County,7684,7671,7735,-13,64,17,63,35,163,-18,-100,0,-2,6,166,6,164,-1,0,5,5,5,8.178631702,21.16058678,-12.98195508,-0.259639102,21.55004544,21.29040634
50,3,7,48,85,Texas,Collin County,1064465,1073149,1109462,8684,36313,2804,11297,1494,6467,1310,4830,143,1625,7131,30191,7274,31816,100,-333,3648,3648,3648,10.35182174,5.925929999,4.425891742,1.489042253,27.66503055,29.15407281
50,3,7,48,87,Texas,Collingsworth County,2652,2635,2615,-17,-20,8,30,14,35,-6,-5,0,0,-11,-15,-11,-15,0,0,23,23,23,11.42857143,13.33333333,-1.904761905,0,-5.714285714,-5.714285714
50,3,7,48,89,Texas,Colorado County,20557,20566,20630,9,64,48,236,70,307,-22,-71,2,17,31,116,33,133,-2,2,187,187,187,11.45742305,14.90435965,-3.446936596,0.825322847,5.63161472,6.456937567
50,3,7,48,91,Texas,Comal County,161501,163573,174986,2072,11413,398,1668,401,1617,-3,51,2,27,2066,11530,2068,11557,7,-195,941,941,941,9.853526269,9.552249386,0.301276882,0.159499526,68.11220496,68.27170449
50,3,7,48,93,Texas,Comanche County,13594,13600,13775,6,175,28,140,63,224,-35,-84,1,0,40,262,41,262,0,-3,96,96,96,10.2283105,16.3652968,-6.136986301,0,19.14155251,19.14155251
50,3,7,48,95,Texas,Concho County,3303,3319,3341,16,22,7,19,8,50,-1,-31,0,6,18,46,18,52,-1,1,40,40,40,5.705705706,15.01501502,-9.309309309,1.801801802,13.81381381,15.61561562
50,3,7,48,97,Texas,Cooke County,41668,41697,42244,29,547,121,490,148,518,-27,-28,0,8,57,568,57,576,-1,-1,563,563,563,11.67486687,12.34200212,-0.66713525,0.190610071,13.53331507,13.72392514
50,3,7,48,99,Texas,Coryell County,83093,83096,84232,3,1136,226,927,157,580,69,347,2,12,-75,766,-73,778,7,11,13691,13691,13691,11.08003442,6.932491872,4.147542551,0.143430866,9.1556703,9.299101167
50,3,7,48,101,Texas,Cottle County,1380,1374,1381,-6,7,3,9,2,13,1,-4,0,0,-6,10,-6,10,-1,1,0,0,0,6.533575318,9.43738657,-2.903811252,0,7.259528131,7.259528131
50,3,7,48,103,Texas,Crane County,4675,4668,4680,-7,12,19,85,20,31,-1,54,0,4,-6,-47,-6,-43,0,1,66,66,66,18.18570817,6.632434745,11.55327343,0.855798032,-10.05562687,-9.19982884
50,3,7,48,105,Texas,Crockett County,3098,3111,3068,13,-43,15,48,8,34,7,14,0,0,6,-57,6,-57,0,0,9,9,9,15.53649458,11.00501699,4.531477585,0,-18.44958731,-18.44958731
50,3,7,48,107,Texas,Crosby County,5133,5098,5106,-35,8,13,59,14,66,-1,-7,0,0,-34,14,-34,14,0,1,33,33,33,11.56409251,12.93610349,-1.372010976,0,2.744021952,2.744021952
50,3,7,48,109,Texas,Culberson County,2188,2193,2193,5,0,10,25,5,27,5,-2,0,0,1,1,1,1,-1,1,12,12,12,11.3999088,12.31190151,-0.911992704,0,0.455996352,0.455996352
50,3,7,48,111,Texas,Dallam County,7115,7116,7172,1,56,40,158,17,49,23,109,4,28,-27,-81,-23,-53,1,0,19,19,19,22.11646137,6.858902576,15.25755879,3.9193729,-11.33818589,-7.41881299
50,3,7,48,113,Texas,Dallas County,2613539,2610957,2586050,-2582,-24907,8741,35991,4968,20305,3773,15686,218,4340,-6755,-44650,-6537,-40310,182,-283,29740,29740,29740,13.85066443,7.814113008,6.036551423,1.670192093,-17.18296704,-15.51277495
50,3,7,48,115,Texas,Dawson County,12456,12439,12413,-17,-26,44,165,42,136,2,29,0,2,-19,-60,-19,-58,0,3,1439,1439,1439,13.27860937,10.94479318,2.333816192,0.160952841,-4.828585225,-4.667632384
50,3,7,48,117,Texas,Deaf Smith County,18583,18503,18329,-80,-174,72,302,45,188,27,114,0,5,-108,-292,-108,-287,1,-1,325,325,325,16.39878367,10.20851434,6.190269331,0.271503041,-15.85577758,-15.58427454
50,3,7,48,119,Texas,Delta County,5230,5233,5392,3,159,15,66,11,58,4,8,0,0,-1,153,-1,153,0,-2,28,28,28,12.42352941,10.91764706,1.505882353,0,28.8,28.8
50,3,7,48,121,Texas,Denton County,906422,913900,941647,7478,27747,2444,9905,1200,5773,1244,4132,61,730,6071,23087,6132,23817,102,-202,11299,11299,11299,10.67609713,6.2224239,4.45367323,0.786829975,24.88430635,25.67113633
50,3,7,48,123,Texas,DeWitt County,19824,19809,19918,-15,109,37,227,68,280,-31,-53,0,-1,18,160,18,159,-2,3,1656,1656,1656,11.42799607,14.09620661,-2.668210537,-0.050343595,8.054975206,8.004631611
50,3,7,48,125,Texas,Dickens County,1770,1760,1740,-10,-20,5,11,5,31,0,-20,0,1,-9,-1,-9,0,-1,0,222,222,222,6.285714286,17.71428571,-11.42857143,0.571428571,-0.571428571,0
50,3,7,48,127,Texas,Dimmit County,8615,8563,8473,-52,-90,33,121,37,101,-4,20,0,-1,-48,-109,-48,-110,0,0,29,29,29,14.20521249,11.85724348,2.347969007,-0.11739845,-12.79643109,-12.91382954
50,3,7,48,129,Texas,Donley County,3258,3269,3268,11,-1,8,33,12,51,-4,-18,0,0,15,17,15,17,0,0,217,217,217,10.09637448,15.60348784,-5.507113355,0,5.201162613,5.201162613
50,3,7,48,131,Texas,Duval County,9831,9808,9756,-23,-52,30,155,35,149,-5,6,0,5,-18,-63,-18,-58,0,0,464,464,464,15.84543038,15.23205888,0.613371499,0.511142916,-6.440400736,-5.92925782
50,3,7,48,133,Texas,Eastland County,17725,17754,17864,29,110,65,206,85,328,-20,-122,0,6,50,228,50,234,-1,-2,638,638,638,11.56718513,18.417654,-6.850468864,0.336908305,12.80251558,13.13942389
50,3,7,48,135,Texas,Ector County,165171,165467,161091,296,-4376,750,3059,368,1467,382,1592,3,134,-105,-6012,-102,-5878,16,-90,2234,2234,2234,18.73480362,8.984621415,9.750182204,0.820681165,-36.82041169,-35.99973052
50,3,7,48,137,Texas,Edwards County,1422,1414,1438,-8,24,3,19,10,18,-7,1,0,0,-1,22,-1,22,0,1,1,1,1,13.32398317,12.6227209,0.701262272,0,15.42776999,15.42776999
50,3,7,48,139,Texas,Ellis County,192455,194272,202678,1817,8406,553,2182,374,1735,179,447,0,11,1624,8072,1624,8083,14,-124,1353,1353,1353,10.99382794,8.74165512,2.252172818,0.055422597,40.67010959,40.72553218
50,3,7,48,141,Texas,El Paso County,865657,866093,867947,436,1854,2790,10986,1717,6772,1073,4214,-79,-152,-600,-2397,-679,-2549,42,189,16799,16799,16799,12.67098798,7.810661807,4.860326175,-0.175313142,-2.764642107,-2.939955249
50,3,7,48,143,Texas,Erath County,42545,42715,43378,170,663,108,454,86,422,22,32,-1,0,148,633,147,633,1,-2,3361,3361,3361,10.54673435,9.803352189,0.743382157,0,14.70502828,14.70502828
50,3,7,48,145,Texas,Falls County,16968,16961,17313,-7,352,46,200,47,211,-1,-11,0,-2,-5,367,-5,365,-1,-2,1792,1792,1792,11.67065414,12.31254012,-0.641885978,-0.116706541,21.41565035,21.29894381
50,3,7,48,147,Texas,Fannin County,35662,35732,36569,70,837,81,346,137,499,-56,-153,1,13,127,988,128,1001,-2,-11,2874,2874,2874,9.571098602,13.80340521,-4.232306607,0.359607751,27.33018907,27.68979682
50,3,7,48,149,Texas,Fayette County,24435,24452,24687,17,235,38,226,91,350,-53,-124,0,10,74,351,74,361,-4,-2,284,284,284,9.198396386,14.24530414,-5.046907751,0.40700869,14.28600501,14.6930137
50,3,7,48,151,Texas,Fisher County,3672,3677,3706,5,29,12,30,8,47,4,-17,0,3,2,44,2,47,-1,-1,16,16,16,8.126777733,12.73195178,-4.605174048,0.812677773,11.91927401,12.73195178
50,3,7,48,153,Texas,Floyd County,5402,5378,5350,-24,-28,13,70,15,68,-2,2,0,1,-22,-31,-22,-30,0,0,17,17,17,13.04996271,12.67710664,0.372856078,0.186428039,-5.779269202,-5.592841163
50,3,7,48,155,Texas,Foard County,1095,1086,1080,-9,-6,4,17,9,16,-5,1,0,0,-4,-6,-4,-6,0,-1,25,25,25,15.69713758,14.77377655,0.923361034,0,-5.540166205,-5.540166205
50,3,7,48,157,Texas,Fort Bend County,822779,828632,858527,5853,29895,2135,8725,1144,4924,991,3801,186,1704,4618,24712,4804,26416,58,-322,4600,4600,4600,10.34283076,5.837031365,4.505799394,2.019963738,29.2942159,31.31417964
50,3,7,48,159,Texas,Franklin County,10359,10366,10464,7,98,20,101,33,147,-13,-46,0,4,20,140,20,144,0,0,26,26,26,9.697551608,14.11425828,-4.416706673,0.38406145,13.44215074,13.82621219
50,3,7,48,161,Texas,Freestone County,19435,19445,19774,10,329,58,206,73,267,-15,-61,1,2,26,391,27,393,-2,-3,1473,1473,1473,10.50511232,13.61584946,-3.110737143,0.101991382,19.93931513,20.04130651
50,3,7,48,163,Texas,Frio County,18385,18366,18436,-19,70,51,220,50,172,1,48,1,124,-21,-106,-20,18,0,4,2919,2919,2919,11.95587196,9.347318081,2.608553883,6.738764198,-5.760556491,0.978207706
50,3,7,48,165,Texas,Gaines County,21598,21701,21895,103,194,120,447,45,144,75,303,5,32,22,-145,27,-113,1,4,29,29,29,20.50646848,6.606110652,13.90035783,1.468024589,-6.651986421,-5.183961831
50,3,7,48,167,Texas,Galveston County,350682,351458,355062,776,3604,940,3814,832,3631,108,183,-1,158,662,3246,661,3404,7,17,4699,4699,4699,10.79658042,10.27854838,0.518032044,0.447262639,9.188699541,9.635962181
50,3,7,48,169,Texas,Garza County,5816,5794,5863,-22,69,12,50,18,39,-6,11,0,25,-16,31,-16,56,0,2,1643,1643,1643,8.578536502,6.691258471,1.88727803,4.289268251,5.318692631,9.607960882
50,3,7,48,171,Texas,Gillespie County,26725,26732,27297,7,565,64,252,96,417,-32,-165,0,27,43,713,43,740,-4,-10,186,186,186,9.328323678,15.43615466,-6.10783098,0.999463251,26.39323326,27.39269652
50,3,7,48,173,Texas,Glasscock County,1116,1114,1149,-2,35,2,19,1,10,1,9,0,7,-2,19,-2,26,-1,0,0,0,0,16.7918692,8.837825895,7.954043305,6.186478126,16.7918692,22.97834733
50,3,7,48,175,Texas,Goliad County,7012,7005,7163,-7,158,8,80,19,78,-11,2,0,1,5,158,5,159,-1,-3,40,40,40,11.29305477,11.0107284,0.282326369,0.141163185,22.30378317,22.44494636
50,3,7,48,177,Texas,Gonzales County,19653,19653,19641,0,-12,60,254,57,240,3,14,0,3,-2,-32,-2,-29,-1,3,169,169,169,12.92818242,12.21560544,0.712576984,0.152695068,-1.628747391,-1.476052324
50,3,7,48,179,Texas,Gray County,21227,21179,21030,-48,-149,62,258,65,292,-3,-34,0,2,-44,-117,-44,-115,-1,0,1829,1829,1829,12.22488095,13.83591177,-1.611030823,0.094766519,-5.543841361,-5.449074842
50,3,7,48,181,Texas,Grayson County,135543,136014,139336,471,3322,396,1500,420,1806,-24,-306,2,14,494,3655,496,3669,-1,-41,1987,1987,1987,10.89522426,13.11785001,-2.222625749,0.10168876,26.54802978,26.64971854
50,3,7,48,183,Texas,Gregg County,124239,124175,124201,-64,26,384,1667,401,1551,-17,116,-1,24,-47,-140,-48,-116,1,26,3761,3761,3761,13.42319709,12.48912938,0.934067704,0.193255387,-1.127323091,-0.934067704
50,3,7,48,185,Texas,Grimes County,29268,29414,30287,146,873,72,291,85,327,-13,-36,0,1,159,920,159,921,0,-12,2817,2817,2817,9.748580426,10.95459038,-1.20600995,0.033500276,30.82025427,30.85375454
50,3,7,48,187,Texas,Guadalupe County,172706,173541,177036,835,3495,414,1799,354,1474,60,325,-1,-3,769,3195,768,3192,7,-22,1767,1767,1767,10.26308058,8.408994315,1.854086264,-0.017114642,18.22709419,18.20997955
50,3,7,48,189,Texas,Hale County,32522,32439,32220,-83,-219,110,362,84,386,26,-24,0,15,-111,-214,-111,-199,2,4,2367,2367,2367,11.19720379,11.93955985,-0.742356053,0.463972533,-6.619341468,-6.155368935
50,3,7,48,191,Texas,Hall County,2825,2801,2845,-24,44,2,17,14,56,-12,-39,0,3,-11,83,-11,86,-1,-3,22,22,22,6.021962451,19.83705278,-13.81509033,1.062699256,29.40134609,30.46404534
50,3,7,48,193,Texas,Hamilton County,8222,8230,8229,8,-1,18,74,39,143,-21,-69,0,3,29,65,29,68,0,0,108,108,108,8.992040829,17.37651133,-8.384470502,0.364542196,7.898414241,8.262956437
50,3,7,48,195,Texas,Hansford County,5285,5255,5159,-30,-96,17,79,12,46,5,33,0,11,-35,-139,-35,-128,0,-1,48,48,48,15.171884,8.834261571,6.337622431,2.11254081,-26.69483388,-24.58229307
50,3,7,48,197,Texas,Hardeman County,3549,3559,3552,10,-7,7,34,16,46,-9,-12,0,6,20,-1,20,5,-1,0,2,2,2,9.562649416,12.93770215,-3.375052735,1.687526368,-0.281254395,1.406271973
50,3,7,48,199,Texas,Hardin County,56231,56277,56973,46,696,146,659,200,722,-54,-63,-1,14,102,749,101,763,-1,-4,291,291,291,11.6379691,12.75055188,-1.112582781,0.247240618,13.22737307,13.47461369
50,3,7,48,201,Texas,Harris County,4731145,4732491,4728030,1346,-4461,15329,63336,8000,33862,7329,29474,289,10081,-6615,-44409,-6326,-34328,343,393,46039,46039,46039,13.38953743,7.158590949,6.230946478,2.131172268,-9.388277876,-7.257105608
50,3,7,48,203,Texas,Harrison County,68839,68778,69150,-61,372,168,763,200,807,-32,-44,0,8,-28,400,-28,408,-1,8,1030,1030,1030,11.0637434,11.70175744,-0.638014036,0.116002552,5.800127603,5.916130155
50,3,7,48,205,Texas,Hartley County,5382,5362,5397,-20,35,21,62,11,30,10,32,0,4,-30,-2,-30,2,0,1,1082,1082,1082,11.52523469,5.576726462,5.948508226,0.743563528,-0.371781764,0.371781764
50,3,7,48,207,Texas,Haskell County,5416,5424,5411,8,-13,9,49,22,74,-13,-25,0,7,21,6,21,13,0,-1,425,425,425,9.044762344,13.65943701,-4.614674665,1.292108906,1.10752192,2.399630826
50,3,7,48,209,Texas,Hays County,241067,243809,255397,2742,11588,613,2490,326,1491,287,999,4,144,2420,10590,2424,10734,31,-145,7398,7398,7398,9.975841637,5.973485896,4.002355741,0.576916143,42.42737467,43.00429081
50,3,7,48,211,Texas,Hemphill County,3382,3368,3271,-14,-97,9,25,7,32,2,-7,0,3,-15,-93,-15,-90,-1,0,16,16,16,7.531254707,9.640006025,-2.108751318,0.903750565,-28.01626751,-27.11251695
50,3,7,48,213,Texas,Henderson County,82150,82348,83667,198,1319,226,931,340,1333,-114,-402,-1,0,318,1738,317,1738,-5,-17,1029,1029,1029,11.21585399,16.05878987,-4.842935879,0,20.93786706,20.93786706
50,3,7,48,215,Texas,Hidalgo County,870781,872204,880356,1423,8152,3214,13191,1450,5852,1764,7339,-80,15,-325,554,-405,569,64,244,6669,6669,6669,15.05340759,6.678230703,8.375176884,0.017117816,0.632218013,0.649335829
50,3,7,48,217,Texas,Hill County,35874,35965,36471,91,506,108,397,133,535,-25,-138,0,9,117,640,117,649,-1,-5,471,471,471,10.96140041,14.7716605,-3.810260092,0.248495223,17.67077144,17.91926666
50,3,7,48,219,Texas,Hockley County,21537,21490,21363,-47,-127,56,245,55,262,1,-17,0,10,-49,-123,-49,-113,1,3,632,632,632,11.43443866,12.22784869,-0.79341003,0.466711782,-5.74055492,-5.273843138
50,3,7,48,221,Texas,Hood County,61598,61953,64222,355,2269,122,553,244,878,-122,-325,0,0,481,2632,481,2632,-4,-38,539,539,539,8.765603329,13.91717852,-5.151575193,0,41.71983356,41.71983356
50,3,7,48,223,Texas,Hopkins County,36787,36795,37211,8,416,108,435,116,510,-8,-75,0,8,18,486,18,494,-2,-3,313,313,313,11.75580358,13.78266627,-2.026862687,0.216198687,13.13407021,13.3502689
50,3,7,48,225,Texas,Houston County,22066,22068,22241,2,173,56,198,75,353,-19,-155,0,2,23,328,23,330,-2,-2,2454,2454,2454,8.937236227,15.93355752,-6.996321289,0.090275113,14.8051186,14.89539371
50,3,7,48,227,Texas,Howard County,34860,34797,34128,-63,-669,117,383,94,378,23,5,0,49,-87,-718,-87,-669,1,-5,5388,5388,5388,11.1135292,10.96844396,0.145085238,1.421835328,-20.83424012,-19.41240479
50,3,7,48,229,Texas,Hudspeth County,3202,3196,3287,-6,91,13,40,11,26,2,14,0,34,-8,44,-8,78,0,-1,28,28,28,12.33996607,8.020977942,4.318988123,10.48897116,13.57396267,24.06293383
50,3,7,48,231,Texas,Hunt County,99956,100231,103394,275,3163,269,1160,276,1226,-7,-66,8,26,274,3250,282,3276,0,-47,2539,2539,2539,11.39349294,12.0417434,-0.64825046,0.255371394,31.92142419,32.17679558
50,3,7,48,233,Texas,Hutchinson County,20617,20539,20495,-78,-44,66,257,86,263,-20,-6,0,1,-58,-42,-58,-41,0,3,184,184,184,12.52619779,12.8186382,-0.292440415,0.048740069,-2.047082907,-1.998342838
50,3,7,48,235,Texas,Irion County,1513,1522,1552,9,30,11,18,1,19,10,-1,0,0,-2,31,-2,31,1,0,0,0,0,11.71112557,12.36174366,-0.650618087,0,20.1691607,20.1691607
50,3,7,48,237,Texas,Jack County,8472,8492,8712,20,220,21,78,27,102,-6,-24,0,1,26,247,26,248,0,-4,978,978,978,9.067658684,11.85770751,-2.790048826,0.116252034,28.7142525,28.83050453
50,3,7,48,239,Texas,Jackson County,14988,15000,15121,12,121,48,200,39,166,9,34,0,-1,3,86,3,85,0,2,186,186,186,13.27977159,11.02221042,2.25756117,-0.066398858,5.710301783,5.643902925
50,3,7,48,241,Texas,Jasper County,32980,32900,32975,-80,75,92,376,134,504,-42,-128,0,3,-36,197,-36,200,-2,3,683,683,683,11.41555977,15.30170778,-3.886148008,0.091081594,5.981024668,6.072106262
50,3,7,48,243,Texas,Jeff Davis County,1996,1978,1949,-18,-29,2,12,8,36,-6,-24,0,2,-11,-8,-11,-6,-1,1,80,80,80,6.111535523,18.33460657,-12.22307105,1.018589254,-4.074357016,-3.055767762
50,3,7,48,245,Texas,Jefferson County,256526,255979,253704,-547,-2275,733,3168,754,2935,-21,233,3,142,-538,-2659,-535,-2517,9,9,15907,15907,15907,12.43125629,11.5169625,0.914293787,0.557209089,-10.43393639,-9.876727299
50,3,7,48,247,Texas,Jim Hogg County,4838,4839,4801,1,-38,16,56,21,65,-5,-9,0,4,6,-34,6,-30,0,1,3,3,3,11.61825726,13.48547718,-1.867219917,0.829875519,-7.053941909,-6.22406639
50,3,7,48,249,Texas,Jim Wells County,38891,38813,38847,-78,34,107,473,121,503,-14,-30,0,19,-66,37,-66,56,2,8,221,221,221,12.18130312,12.95390162,-0.772598506,0.489312387,0.952871491,1.442183878
50,3,7,48,251,Texas,Johnson County,179927,180733,187280,806,6547,504,2114,469,1808,35,306,1,19,763,6312,764,6331,7,-90,2459,2459,2459,11.48872458,9.825739852,1.662984732,0.103257222,34.30313603,34.40639325
50,3,7,48,253,Texas,Jones County,19663,19676,19873,13,197,43,143,43,200,0,-57,0,0,12,253,12,253,1,1,4974,4974,4974,7.231535564,10.11403575,-2.88250019,0,12.79425523,12.79425523
50,3,7,48,255,Texas,Karnes County,14710,14721,14754,11,33,31,170,55,178,-24,-8,0,64,35,-25,35,39,0,2,2399,2399,2399,11.53519932,12.07803223,-0.542832909,4.342663274,-1.696352841,2.646310433
50,3,7,48,257,Texas,Kaufman County,145310,146986,157768,1676,10782,411,1820,334,1353,77,467,1,12,1581,10498,1582,10510,17,-195,1183,1183,1183,11.9440598,8.879292807,3.064766992,0.078752043,68.89491196,68.973664
50,3,7,48,259,Texas,Kendall County,44279,44527,46788,248,2261,95,394,120,509,-25,-115,0,11,274,2405,274,2416,-1,-40,328,328,328,8.629469419,11.14822318,-2.518753764,0.240924273,52.67480699,52.91573126
50,3,7,48,261,Texas,Kenedy County,350,346,340,-4,-6,0,2,1,2,-1,0,0,1,-3,-8,-3,-7,0,1,0,0,0,5.83090379,5.83090379,0,2.915451895,-23.32361516,-20.40816327
50,3,7,48,263,Texas,Kent County,753,759,749,6,-10,0,3,3,10,-3,-7,0,0,9,-2,9,-2,0,-1,42,42,42,3.978779841,13.26259947,-9.283819629,0,-2.652519894,-2.652519894
50,3,7,48,265,Texas,Kerr County,52598,52676,53161,78,485,118,475,204,872,-86,-397,-1,12,172,879,171,891,-7,-9,1765,1765,1765,8.976066971,16.47816926,-7.502102289,0.226763797,16.61044814,16.83721194
50,3,7,48,267,Texas,Kimble County,4286,4289,4365,3,76,12,44,18,48,-6,-4,0,0,9,83,9,83,0,-3,14,14,14,10.16870811,11.09313612,-0.92442801,0,19.18188121,19.18188121
50,3,7,48,269,Texas,King County,265,270,258,5,-12,2,2,0,2,2,0,0,0,3,-12,3,-12,0,0,0,0,0,7.575757576,7.575757576,0,0,-45.45454545,-45.45454545
50,3,7,48,271,Texas,Kinney County,3129,3127,3130,-2,3,10,27,10,47,0,-20,0,9,-1,14,-1,23,-1,0,257,257,257,8.630334026,15.02317405,-6.392840019,2.876778009,4.474988013,7.351766022
50,3,7,48,273,Texas,Kleberg County,31040,30958,30635,-82,-323,95,380,90,331,5,49,2,24,-91,-398,-89,-374,2,2,1331,1331,1331,12.3390645,10.74797461,1.591089897,0.779309337,-12.92354651,-12.14423717
50,3,7,48,275,Texas,Knox County,3353,3361,3351,8,-10,13,36,7,42,6,-6,0,3,2,-8,2,-5,0,1,51,51,51,10.72705602,12.51489869,-1.78784267,0.893921335,-2.383790226,-1.489868892
50,3,7,48,277,Texas,Lamar County,50088,50077,50098,-11,21,134,586,194,798,-60,-212,-1,8,52,220,51,228,-2,5,564,564,564,11.69952583,15.93211879,-4.232592962,0.159720489,4.392313452,4.552033941
50,3,7,48,279,Texas,Lamb County,13045,12984,12898,-61,-86,34,156,43,161,-9,-5,0,3,-52,-86,-52,-83,0,2,163,163,163,12.05470984,12.44107874,-0.386368905,0.231821343,-6.645545167,-6.413723824
50,3,7,48,281,Texas,Lampasas County,21627,21707,22252,80,545,53,196,63,250,-10,-54,0,1,91,604,91,605,-1,-6,166,166,166,8.917400305,11.37423508,-2.456834778,0.04549694,27.48015196,27.5256489
50,3,7,48,283,Texas,La Salle County,6664,6642,6670,-22,28,17,74,14,46,3,28,0,14,-25,-16,-25,-2,0,2,1396,1396,1396,11.11778846,6.911057692,4.206730769,2.103365385,-2.403846154,-0.300480769
50,3,7,48,285,Texas,Lavaca County,20337,20338,20544,1,206,54,234,75,277,-21,-43,0,4,24,247,24,251,-2,-2,369,369,369,11.44758084,13.55119613,-2.103615283,0.195685143,12.08355756,12.2792427
50,3,7,48,287,Texas,Lee County,17478,17499,17706,21,207,46,192,35,178,11,14,0,1,11,192,11,193,-1,0,436,436,436,10.90754154,10.11219997,0.795341571,0.056810112,10.90754154,10.96435166
50,3,7,48,289,Texas,Leon County,15719,15727,15959,8,232,51,184,69,280,-18,-96,0,2,27,328,27,330,-1,-2,39,39,39,11.613962,17.67342044,-6.059458436,0.126238717,20.70314966,20.82938837
50,3,7,48,291,Texas,Liberty County,91628,92351,97621,723,5270,257,1169,234,968,23,201,1,4,695,5164,696,5168,4,-99,4761,4761,4761,12.30707683,10.19097551,2.11610132,0.042111469,54.36590656,54.40801802
50,3,7,48,293,Texas,Limestone County,22146,22103,22119,-43,16,55,221,97,318,-42,-97,1,3,0,107,1,110,-2,3,1276,1276,1276,9.995025101,14.38198182,-4.386956718,0.135679074,4.839220298,4.974899371
50,3,7,48,295,Texas,Lipscomb County,3059,3042,2931,-17,-111,13,46,5,30,8,16,0,1,-24,-127,-24,-126,-1,-1,22,22,22,15.40264524,10.04520342,5.357441822,0.334840114,-42.52469446,-42.18985434
50,3,7,48,297,Texas,Live Oak County,11335,11343,11377,8,34,31,117,34,112,-3,5,0,6,13,22,13,28,-2,1,963,963,963,10.29929578,9.85915493,0.440140845,0.528169014,1.936619718,2.464788732
50,3,7,48,299,Texas,Llano County,21243,21249,21978,6,729,40,167,115,419,-75,-252,0,5,86,995,86,1000,-5,-19,77,77,77,7.726652324,19.38603188,-11.65937955,0.231336896,46.03604229,46.26737918
50,3,7,48,301,Texas,Loving County,64,67,57,3,-10,1,1,0,3,1,-2,0,0,2,-7,2,-7,0,-1,0,0,0,16.12903226,48.38709677,-32.25806452,0,-112.9032258,-112.9032258
50,3,7,48,303,Texas,Lubbock County,310639,311419,314451,780,3032,981,3943,789,3165,192,778,-1,182,572,2021,571,2203,17,51,11821,11821,11821,12.60006072,10.11392142,2.486139294,0.581590426,6.458210171,7.039800598
50,3,7,48,305,Texas,Lynn County,5596,5606,5688,10,82,16,88,20,61,-4,27,0,0,13,56,13,56,1,-1,14,14,14,15.58349566,10.80219586,4.781299805,0,9.916769966,9.916769966
50,3,7,48,307,Texas,McCulloch County,7630,7567,7533,-63,-34,16,69,41,120,-25,-51,0,2,-37,14,-37,16,-1,1,65,65,65,9.139072848,15.89403974,-6.754966887,0.264900662,1.854304636,2.119205298
50,3,7,48,309,Texas,McLennan County,260579,261023,263115,444,2092,785,3144,682,2692,103,452,-1,86,337,1512,336,1598,5,42,8339,8339,8339,11.99684053,10.27210391,1.724736615,0.328157852,5.769472925,6.097630777
50,3,7,48,311,Texas,McMullen County,600,599,608,-1,9,2,8,1,6,1,2,0,0,-1,7,-1,7,-1,0,0,0,0,13.25600663,9.942004971,3.314001657,0,11.5990058,11.5990058
50,3,7,48,313,Texas,Madison County,13455,13445,13718,-10,273,31,162,34,150,-3,12,0,13,-7,249,-7,262,0,-1,2280,2280,2280,11.92799028,11.04443545,0.883554836,0.957184405,18.33376284,19.29094724
50,3,7,48,315,Texas,Marion County,9725,9752,9645,27,-107,21,94,43,178,-22,-84,0,0,50,-21,50,-21,-1,-2,95,95,95,9.692220447,18.35335361,-8.661133165,0,-2.165283291,-2.165283291
50,3,7,48,317,Texas,Martin County,5237,5250,5211,13,-39,20,80,14,53,6,27,0,0,6,-66,6,-66,1,0,7,7,7,15.29490489,10.13287449,5.162030399,0,-12.61829653,-12.61829653
50,3,7,48,319,Texas,Mason County,3953,3964,3943,11,-21,4,35,11,46,-7,-11,0,2,18,-11,18,-9,0,-1,0,0,0,8.852915139,11.6352599,-2.782344758,0.505880865,-2.782344758,-2.276463893
50,3,7,48,321,Texas,Matagorda County,36255,36269,36344,14,75,132,500,96,458,36,42,0,8,-20,16,-20,24,-2,9,225,225,225,13.77163869,12.61482104,1.15681765,0.220346219,0.440692438,0.661038657
50,3,7,48,323,Texas,Maverick County,57887,57844,58056,-43,212,240,1014,128,472,112,542,4,44,-163,-384,-159,-340,4,10,966,966,966,17.49784297,8.144952545,9.352890423,0.759275237,-6.626402071,-5.867126833
50,3,7,48,325,Texas,Medina County,50748,50920,51981,172,1061,143,553,133,586,10,-33,0,2,163,1102,163,1104,-1,-10,2073,2073,2073,10.74819487,11.38958805,-0.641393184,0.038872314,21.41864511,21.45751742
50,3,7,48,327,Texas,Menard County,1962,1971,1982,9,11,4,16,2,34,2,-18,0,2,8,27,8,29,-1,0,20,20,20,8.095117632,17.20212497,-9.107007336,1.011889704,13.660511,14.67240071
50,3,7,48,329,Texas,Midland County,169983,170221,167969,238,-2252,725,2843,341,1363,384,1480,0,150,-163,-3847,-163,-3697,17,-35,1128,1128,1128,16.81303409,8.060557675,8.752476419,0.887075313,-22.75052485,-21.86344954
50,3,7,48,331,Texas,Milam County,24754,24724,25106,-30,382,53,240,91,322,-38,-82,0,1,10,467,10,468,-2,-4,338,338,338,9.632751355,12.9239414,-3.291190046,0.040136464,18.74372868,18.78386514
50,3,7,48,333,Texas,Mills County,4456,4439,4480,-17,41,7,33,25,90,-18,-57,0,1,2,99,2,100,-1,-2,83,83,83,7.399932728,20.18163471,-12.78170198,0.224240386,22.19979818,22.42403857
50,3,7,48,335,Texas,Mitchell County,8990,8985,9070,-5,85,20,80,35,70,-15,10,0,2,8,74,8,76,2,-1,1502,1502,1502,8.861811133,7.754084741,1.107726392,0.221545278,8.197175298,8.418720576
50,3,7,48,337,Texas,Montague County,19965,19969,20409,4,440,50,190,101,358,-51,-168,0,1,56,616,56,617,-1,-9,167,167,167,9.411065432,17.73242855,-8.321363119,0.049531923,30.51166477,30.56119669
50,3,7,48,339,Texas,Montgomery County,620443,624938,648886,4495,23948,1768,7178,1201,5310,567,1868,25,449,3864,21928,3889,22377,39,-297,2823,2823,2823,11.27000276,8.337101515,2.932901249,0.704963951,34.42861808,35.13358203
50,3,7,48,341,Texas,Moore County,21358,21273,21118,-85,-155,93,367,37,162,56,205,0,29,-143,-387,-143,-358,2,-2,139,139,139,17.31499611,7.643131797,9.671864311,1.368214951,-18.25859263,-16.89037767
50,3,7,48,343,Texas,Morris County,11973,11963,12030,-10,67,30,155,53,197,-23,-42,0,-2,14,111,14,109,-1,0,74,74,74,12.92043513,16.42145626,-3.501021131,-0.166715292,9.252698704,9.085983412
50,3,7,48,345,Texas,Motley County,1063,1052,1067,-11,15,1,14,10,20,-9,-6,0,0,-2,21,-2,21,0,0,0,0,0,13.21378009,18.87682869,-5.663048608,0,19.82067013,19.82067013
50,3,7,48,347,Texas,Nacogdoches County,64653,64624,64668,-29,44,190,757,161,773,29,-16,-1,-16,-58,62,-59,46,1,14,4438,4438,4438,11.70992792,11.95742969,-0.247501779,-0.247501779,0.959069393,0.711567614
50,3,7,48,349,Texas,Navarro County,52624,52784,53591,160,807,136,637,153,659,-17,-22,2,1,175,835,177,836,0,-7,657,657,657,11.97649824,12.39012926,-0.413631022,0.01880141,15.69917744,15.71797885
50,3,7,48,351,Texas,Newton County,12217,12163,12241,-54,78,22,119,39,215,-17,-96,0,1,-35,174,-35,175,-2,-1,537,537,537,9.75249959,17.62006229,-7.867562695,0.081953778,14.25995738,14.34191116
50,3,7,48,353,Texas,Nolan County,14738,14721,14597,-17,-124,46,186,49,229,-3,-43,0,17,-14,-99,-14,-82,0,1,349,349,349,12.68845078,15.62180231,-2.933351525,1.159697114,-6.753530254,-5.59383314
50,3,7,48,355,Texas,Nueces County,353178,353090,353079,-88,-11,1004,4258,905,3677,99,581,1,129,-194,-796,-193,-667,6,75,6122,6122,6122,12.0594362,10.41393774,1.645498457,0.365351637,-2.254417852,-1.889066215
50,3,7,48,357,Texas,Ochiltree County,10015,9960,9782,-55,-178,29,127,10,70,19,57,0,12,-74,-244,-74,-232,0,-3,20,20,20,12.86597103,7.091480093,5.774490933,1.215682302,-24.71887347,-23.50319117
50,3,7,48,359,Texas,Oldham County,1758,1761,1717,3,-44,6,9,6,9,0,0,0,0,2,-43,2,-43,1,-1,203,203,203,5.175388154,5.175388154,0,0,-24.72685451,-24.72685451
50,3,7,48,361,Texas,Orange County,84808,84702,84742,-106,40,239,1022,281,1059,-42,-37,0,2,-64,62,-64,64,0,13,559,559,559,12.06298246,12.49970492,-0.436722457,0.023606619,0.731805198,0.755411818
50,3,7,48,363,Texas,Palo Pinto County,28409,28427,28686,18,259,67,318,113,426,-46,-108,0,3,64,366,64,369,0,-2,158,158,158,11.13581847,14.91779455,-3.781976083,0.105054891,12.81669672,12.92175162
50,3,7,48,365,Texas,Panola County,22491,22513,22675,22,162,72,271,73,308,-1,-37,0,1,26,197,26,198,-3,1,236,236,236,11.99433478,13.63193768,-1.637602903,0.044259538,8.719128972,8.76338851
50,3,7,48,367,Texas,Parker County,148222,149432,156764,1210,7332,400,1555,411,1490,-11,65,1,43,1214,7343,1215,7386,6,-119,1028,1028,1028,10.15689297,9.732328313,0.424564658,0.280865851,47.96274282,48.24360867
50,3,7,48,369,Texas,Parmer County,9869,9851,9813,-18,-38,42,147,22,69,20,78,0,12,-37,-128,-37,-116,-1,0,60,60,60,14.95117982,7.017900732,7.933279089,1.220504475,-13.0187144,-11.79820993
50,3,7,48,371,Texas,Pecos County,15193,15165,15118,-28,-47,39,204,32,119,7,85,0,8,-37,-140,-37,-132,2,0,1906,1906,1906,13.47290559,7.859194928,5.613710663,0.528349239,-9.24611168,-8.717762441
50,3,7,48,373,Texas,Polk County,50123,50505,51899,382,1394,123,496,196,798,-73,-302,0,30,455,1693,455,1723,0,-27,3885,3885,3885,9.687121597,15.5853287,-5.898207101,0.585914613,33.06511464,33.65102926
50,3,7,48,375,Texas,Potter County,118525,118173,116547,-352,-1626,407,1563,380,1490,27,73,0,100,-383,-1790,-383,-1690,4,-9,6591,6591,6591,13.31799591,12.69597819,0.622017723,0.852079073,-15.25221541,-14.40013633
50,3,7,48,377,Texas,Presidio County,6131,6102,6140,-29,38,21,104,15,54,6,50,0,6,-34,-18,-34,-12,-1,0,0,0,0,16.9906878,8.822087894,8.168599902,0.980231988,-2.940695965,-1.960463976
50,3,7,48,379,Texas,Rains County,12164,12199,12509,35,310,28,93,32,155,-4,-62,0,2,40,376,40,378,-1,-6,27,27,27,7.527926178,12.54654363,-5.018617452,0.161890886,30.43548648,30.59737737
50,3,7,48,381,Texas,Randall County,140753,141231,143854,478,2623,394,1504,340,1393,54,111,-1,39,423,2493,422,2532,2,-20,2313,2313,2313,10.5512391,9.772523984,0.77871512,0.27360261,17.48952067,17.76312328
50,3,7,48,383,Texas,Reagan County,3385,3376,3253,-9,-123,15,49,5,17,10,32,1,14,-20,-166,-19,-152,0,-3,8,8,8,14.78352693,5.12897873,9.654548197,4.223864836,-50.08296877,-45.85910394
50,3,7,48,385,Texas,Real County,2758,2743,2826,-15,83,7,26,16,53,-9,-27,0,0,-5,112,-5,112,-1,-2,24,24,24,9.337403484,19.03393787,-9.696534387,0,40.22266116,40.22266116
50,3,7,48,387,Texas,Red River County,11587,11550,11555,-37,5,26,134,58,247,-32,-113,0,-1,-3,121,-3,120,-2,-2,88,88,88,11.59922095,21.38065354,-9.78143259,-0.08656135,10.47392339,10.38736204
50,3,7,48,389,Texas,Reeves County,14748,14730,14487,-18,-243,45,218,36,134,9,84,0,17,-27,-341,-27,-324,0,-3,2813,2813,2813,14.92281891,9.172741897,5.75007701,1.163706062,-23.34257453,-22.17886847
50,3,7,48,391,Texas,Refugio County,6741,6747,6756,6,9,15,67,17,69,-2,-2,0,0,9,9,9,9,-1,2,78,78,78,9.923720655,10.21995112,-0.296230467,0,1.333037103,1.333037103
50,3,7,48,393,Texas,Roberts County,827,823,797,-4,-26,2,6,1,12,1,-6,0,0,-4,-20,-4,-20,-1,0,0,0,0,7.407407407,14.81481482,-7.407407407,0,-24.69135802,-24.69135802
50,3,7,48,395,Texas,Robertson County,16757,16740,16958,-17,218,53,198,75,204,-22,-6,1,1,5,223,6,224,-1,0,101,101,101,11.75143926,12.10754347,-0.35610422,0.059350703,13.23520684,13.29455754
50,3,7,48,397,Texas,Rockwall County,107819,109090,116381,1271,7291,264,1070,157,780,107,290,-1,46,1156,7079,1155,7125,9,-124,491,491,491,9.491242776,6.918849874,2.572392902,0.408034736,62.79299777,63.20103251
50,3,7,48,399,Texas,Runnels County,9900,9921,9943,21,22,30,124,44,155,-14,-31,0,1,34,52,34,53,1,0,77,77,77,12.4848973,15.60612163,-3.121224325,0.100684656,5.235602094,5.33628675
50,3,7,48,401,Texas,Rusk County,52214,52225,52743,11,518,148,558,140,638,8,-80,0,3,3,598,3,601,0,-3,5742,5742,5742,10.6318116,12.15608566,-1.524274064,0.057160277,11.39394863,11.45110891
50,3,7,48,403,Texas,Sabine County,9894,9881,10039,-13,158,23,98,51,168,-28,-70,0,1,18,229,18,230,-3,-2,68,68,68,9.83935743,16.86746988,-7.02811245,0.100401606,22.99196787,23.09236948
50,3,7,48,405,Texas,San Augustine County,7918,7919,7922,1,3,19,79,42,158,-23,-79,0,1,26,80,26,81,-2,1,104,104,104,9.974117796,19.94823559,-9.974117796,0.126254656,10.10037245,10.22662711
50,3,7,48,407,Texas,San Jacinto County,27402,27483,27878,81,395,58,298,98,397,-40,-99,0,-2,123,500,123,498,-2,-4,41,41,41,10.76570149,14.34222648,-3.576524991,-0.07225303,18.06325753,17.9910045
50,3,7,48,409,Texas,San Patricio County,68755,68772,69699,17,927,196,832,190,711,6,121,0,25,9,783,9,808,2,-2,444,444,444,12.01695662,10.26929827,1.747658355,0.361086437,11.3092272,11.67031364
50,3,7,48,411,Texas,San Saba County,5730,5730,5827,0,97,15,55,24,65,-9,-10,0,2,9,106,9,108,0,-1,595,595,595,9.518041014,11.24859393,-1.730552912,0.346110582,18.34386086,18.68997145
50,3,7,48,413,Texas,Schleicher County,2451,2442,2429,-9,-13,5,25,5,31,0,-6,0,0,-10,-6,-10,-6,1,-1,0,0,0,10.26483268,12.72839253,-2.463559844,0,-2.463559844,-2.463559844
50,3,7,48,415,Texas,Scurry County,16932,16931,16824,-1,-107,52,193,49,192,3,1,0,8,-5,-117,-5,-109,1,1,1567,1567,1567,11.43534291,11.37609243,0.059250481,0.474003851,-6.932306325,-6.458302474
50,3,7,48,417,Texas,Shackelford County,3105,3122,3212,17,90,12,36,3,42,9,-6,0,0,7,98,7,98,1,-2,8,8,8,11.3672245,13.26176192,-1.894537417,0,30.94411115,30.94411115
50,3,7,48,419,Texas,Shelby County,24022,23926,23939,-96,13,81,310,85,367,-4,-57,-1,-2,-92,68,-93,66,1,4,74,74,74,12.95309725,15.33479578,-2.381698527,-0.083568369,2.841324559,2.757756189
50,3,7,48,421,Texas,Sherman County,2782,2780,2798,-2,18,7,45,5,18,2,27,0,4,-5,-12,-5,-8,1,-1,14,14,14,16.13481535,6.453926138,9.680889208,1.434205809,-4.302617426,-2.868411617
50,3,7,48,423,Texas,Smith County,233479,234063,237186,584,3123,682,2801,642,2589,40,212,0,24,545,2886,545,2910,-1,1,4879,4879,4879,11.88755838,10.98782173,0.899736657,0.10185698,12.24830185,12.35015883
50,3,7,48,425,Texas,Somervell County,9205,9214,9469,9,255,18,63,21,112,-3,-49,0,-1,12,310,12,309,0,-5,257,257,257,6.744098914,11.98950918,-5.245410266,-0.107049189,33.18524862,33.07819943
50,3,7,48,427,Texas,Starr County,65920,65835,66049,-85,214,231,1107,130,512,101,595,1,-68,-192,-324,-191,-392,5,11,796,796,796,16.78747991,7.764399017,9.023080889,-1.031209244,-4.913408753,-5.944617998
50,3,7,48,429,Texas,Stephens County,9101,9079,9173,-22,94,20,86,32,119,-12,-33,0,1,-9,126,-9,127,-1,0,605,605,605,9.423624808,13.03966689,-3.616042078,0.109577033,13.80670611,13.91628315
50,3,7,48,431,Texas,Sterling County,1372,1383,1381,11,-2,3,18,4,15,-1,3,0,0,12,-2,12,-2,0,-3,33,33,33,13.02460203,10.85383502,2.170767004,0,-1.447178003,-1.447178003
50,3,7,48,433,Texas,Stonewall County,1245,1245,1217,0,-28,7,5,10,14,-3,-9,0,0,3,-19,3,-19,0,0,16,16,16,4.061738424,11.37286759,-7.311129163,0,-15.43460601,-15.43460601
50,3,7,48,435,Texas,Sutton County,3372,3362,3319,-10,-43,14,32,10,23,4,9,0,11,-14,-62,-14,-51,0,-1,5,5,5,9.579404281,6.885196827,2.694207454,3.292920222,-18.56009579,-15.26717557
50,3,7,48,437,Texas,Swisher County,6971,6957,7008,-14,51,25,54,19,74,6,-20,0,14,-20,57,-20,71,0,0,545,545,545,7.733619764,10.59792338,-2.864303616,2.005012531,8.163265306,10.16827784
50,3,7,48,439,Texas,Tarrant County,2110640,2114709,2126477,4069,11768,6396,26097,4108,16870,2288,9227,163,1746,1498,208,1661,1954,120,587,24725,24725,24725,12.30646333,7.955321931,4.351141402,0.823354599,0.098085771,0.921440371
50,3,7,48,441,Texas,Taylor County,143208,143383,143326,175,-57,493,1834,416,1719,77,115,5,73,91,-272,96,-199,2,27,4891,4891,4891,12.79345957,11.99125246,0.802207116,0.509227126,-1.897394222,-1.388167096
50,3,7,48,443,Texas,Terrell County,760,744,724,-16,-20,1,5,6,7,-5,-2,0,0,-11,-17,-11,-17,0,-1,0,0,0,6.811989101,9.536784741,-2.72479564,0,-23.16076294,-23.16076294
50,3,7,48,445,Texas,Terry County,11831,11792,11754,-39,-38,43,184,30,134,13,50,-1,1,-52,-90,-53,-89,1,1,909,909,909,15.62898157,11.38197571,4.247005861,0.084940117,-7.64461055,-7.559670432
50,3,7,48,447,Texas,Throckmorton County,1440,1443,1495,3,52,3,18,6,22,-3,-4,0,0,7,58,7,58,-1,-2,9,9,9,12.25323349,14.97617427,-2.722940776,0,39.48264125,39.48264125
50,3,7,48,449,Texas,Titus County,31247,31264,31183,17,-81,113,395,98,347,15,48,-1,-2,2,-131,1,-133,1,4,299,299,299,12.65072782,11.11342418,1.537303634,-0.064054318,-4.195557833,-4.259612151
50,3,7,48,451,Texas,Tom Green County,120003,120105,119411,102,-694,378,1485,319,1264,59,221,8,-4,36,-915,44,-919,-1,4,4814,4814,4814,12.40000668,10.55461848,1.8453882,-0.033400691,-7.640408156,-7.673808848
50,3,7,48,453,Texas,Travis County,1290188,1296100,1305154,5912,9054,3676,14929,1738,7630,1938,7299,142,1768,3686,-172,3828,1596,146,159,21743,21743,21743,11.47831008,5.866401359,5.611908718,1.359344378,-0.13224391,1.227100468
50,3,7,48,455,Texas,Trinity County,13602,13623,13827,21,204,24,122,68,257,-44,-135,0,4,68,340,68,344,-3,-5,94,94,94,8.888888889,18.72495446,-9.836065574,0.29143898,24.7723133,25.06375228
50,3,7,48,457,Texas,Tyler County,19798,19797,20077,-1,280,38,211,75,306,-37,-95,0,3,37,374,37,377,-1,-2,1950,1950,1950,10.58333751,15.34834729,-4.765009781,0.150473993,18.75909114,18.90956513
50,3,7,48,459,Texas,Upshur County,40892,40975,41774,83,799,101,430,138,535,-37,-105,0,-2,120,919,120,917,0,-13,337,337,337,10.39287484,12.93066986,-2.537795019,-0.048338953,22.21174878,22.16340983
50,3,7,48,461,Texas,Upton County,3308,3296,3265,-12,-31,10,47,12,24,-2,23,0,3,-9,-57,-9,-54,-1,0,29,29,29,14.32708429,7.315957933,7.011126353,0.914494742,-17.37540009,-16.46090535
50,3,7,48,463,Texas,Uvalde County,24564,24540,24729,-24,189,97,391,83,364,14,27,0,1,-37,158,-37,159,-1,3,339,339,339,15.87204936,14.77602549,1.096023869,0.040593477,6.413769307,6.454362784
50,3,7,48,465,Texas,Val Verde County,47586,47582,47564,-4,-18,192,742,102,482,90,260,0,2,-95,-289,-95,-287,1,9,1641,1641,1641,15.59708238,10.13179745,5.465284931,0.042040653,-6.074874404,-6.03283375
50,3,7,48,467,Texas,Van Zandt County,59541,59690,61275,149,1585,140,607,206,833,-66,-226,0,22,218,1816,218,1838,-3,-27,511,511,511,10.03596082,13.77257885,-3.73661803,0.363741578,30.02521391,30.38895548
50,3,7,48,469,Texas,Victoria County,91319,91236,90964,-83,-272,286,1224,274,1043,12,181,0,16,-96,-480,-96,-464,1,11,1671,1671,1671,13.43578485,11.44895719,1.986827662,0.175631175,-5.268935236,-5.093304061
50,3,7,48,471,Texas,Walker County,76400,76543,77977,143,1434,159,577,145,735,14,-158,2,82,124,1514,126,1596,3,-4,17768,17768,17768,7.468288895,9.513331608,-2.045042713,1.061351281,19.59616878,20.65752006
50,3,7,48,473,Texas,Waller County,56794,57349,59781,555,2432,180,660,97,431,83,229,0,11,466,2222,466,2233,6,-30,4479,4479,4479,11.26952958,7.359344318,3.910185264,0.187825493,37.94074959,38.12857509
50,3,7,48,475,Texas,Ward County,11644,11656,11194,12,-462,44,197,27,87,17,110,0,5,-6,-566,-6,-561,1,-11,66,66,66,17.2428884,7.61487965,9.628008753,0.437636762,-49.5404814,-49.10284464
50,3,7,48,477,Texas,Washington County,35805,35837,35891,32,54,74,364,94,501,-20,-137,0,4,55,182,55,186,-3,5,2212,2212,2212,10.14945349,13.96944011,-3.819986616,0.111532456,5.074726746,5.186259201
50,3,7,48,479,Texas,Webb County,267114,267234,267945,120,711,1058,4482,445,1713,613,2769,42,155,-563,-2241,-521,-2086,28,28,3231,3231,3231,16.74953614,6.401596475,10.34793966,0.579245449,-8.374768068,-7.79552262
50,3,7,48,481,Texas,Wharton County,41570,41550,41721,-20,171,142,546,121,471,21,75,0,3,-41,85,-41,88,0,8,365,365,365,13.11380913,11.31246172,1.801347408,0.072053896,2.041527062,2.113580959
50,3,7,48,483,Texas,Wheeler County,4990,4980,4927,-10,-53,11,56,7,64,4,-8,0,0,-14,-45,-14,-45,0,0,34,34,34,11.30513778,12.92015746,-1.615019683,0,-9.084485717,-9.084485717
50,3,7,48,485,Texas,Wichita County,129350,129546,130069,196,523,388,1573,355,1678,33,-105,15,49,145,553,160,602,3,26,12025,12025,12025,12.11794388,12.92683397,-0.808890087,0.377482041,4.26015446,4.6376365
50,3,7,48,487,Texas,Wilbarger County,12887,12846,12731,-41,-115,40,159,40,177,0,-18,0,4,-41,-102,-41,-98,0,1,618,618,618,12.43304531,13.84055988,-1.407514564,0.312781014,-7.975915862,-7.663134848
50,3,7,48,489,Texas,Willacy County,20164,20129,20316,-35,187,60,236,57,212,3,24,0,-2,-39,163,-39,161,1,2,3060,3060,3060,11.67016937,10.48337248,1.186796885,-0.09889974,8.060328842,7.961429101
50,3,7,48,491,Texas,Williamson County,609017,615266,643026,6249,27760,1554,6557,899,3961,655,2596,24,366,5506,25128,5530,25494,64,-330,3829,3829,3829,10.4220642,6.295835943,4.126228252,0.581740963,39.93985498,40.52159594
50,3,7,48,493,Texas,Wilson County,49753,49994,51257,241,1263,112,552,114,545,-2,7,0,10,242,1261,242,1271,1,-15,282,282,282,10.90359601,10.76532578,0.138270239,0.197528913,24.90839597,25.10592488
50,3,7,48,495,Texas,Winkler County,7791,7749,7415,-42,-334,22,141,21,67,1,74,0,11,-45,-411,-45,-400,2,-8,82,82,82,18.59667634,8.836718544,9.759957795,1.450804537,-54.20733316,-52.75652862
50,3,7,48,497,Texas,Wise County,68632,68866,71714,234,2848,175,746,208,786,-33,-40,0,4,264,2929,264,2933,3,-45,558,558,558,10.61317399,11.18224499,-0.569070992,0.056907099,41.67022336,41.72713046
50,3,7,48,499,Texas,Wood County,44843,45010,45875,167,865,99,398,173,825,-74,-427,-1,5,248,1303,247,1308,-6,-16,1506,1506,1506,8.758320955,18.15481103,-9.39649007,0.110029158,28.6735985,28.78362766
50,3,7,48,501,Texas,Yoakum County,7694,7669,7607,-25,-62,31,138,24,56,7,82,0,35,-33,-177,-33,-142,1,-2,23,23,23,18.06755695,7.331762241,10.73579471,4.582351401,-23.17360566,-18.59125426
50,3,7,48,503,Texas,Young County,17867,17839,17977,-28,138,47,215,80,276,-33,-61,0,1,5,199,5,200,0,-1,204,204,204,12.00580746,15.41210632,-3.406298861,0.055840965,11.11235202,11.16819299
50,3,7,48,505,Texas,Zapata County,13889,13884,13908,-5,24,50,193,20,130,30,63,0,3,-36,-42,-36,-39,1,0,16,16,16,13.88888889,9.355210132,4.533678757,0.215889465,-3.022452504,-2.80656304
50,3,7,48,507,Texas,Zavala County,9670,9652,9534,-18,-118,34,166,40,119,-6,47,1,5,-13,-168,-12,-163,0,-2,294,294,294,17.30428437,12.40487856,4.899405817,0.521213385,-17.51276973,-16.99155634
40,4,8,49,0,Utah,Utah,3271616,3281684,3337975,10068,56291,11621,45159,5705,22167,5916,22992,40,1180,3884,32200,3924,33380,228,-81,47057,47057,47057,13.64390522,6.697323835,6.946581387,0.356513833,9.728597802,10.08511164
50,4,8,49,1,Utah,Beaver County,7072,7076,7249,4,173,19,93,13,55,6,38,0,5,-2,130,-2,135,0,0,22,22,22,12.98429319,7.678883072,5.305410122,0.698080279,18.15008726,18.84816754
50,4,8,49,3,Utah,Box Elder County,57666,57908,59688,242,1780,211,788,130,481,81,307,-1,9,159,1481,158,1490,3,-17,290,290,290,13.40181639,8.180550359,5.22126603,0.153066431,25.18793156,25.34099799
50,4,8,49,5,Utah,Cache County,133154,133527,137417,373,3890,520,1997,169,662,351,1335,2,69,7,2500,9,2569,13,-14,3969,3969,3969,14.7410535,4.886618637,9.854434865,0.509330341,18.45399787,18.96332822
50,4,8,49,7,Utah,Carbon County,20412,20465,20372,53,-93,57,233,60,238,-3,-5,0,2,58,-93,58,-91,-2,3,448,448,448,11.41122022,11.65609619,-0.24487597,0.097950388,-4.554693048,-4.45674266
50,4,8,49,9,Utah,Daggett County,935,952,976,17,24,5,9,3,7,2,2,0,0,16,21,16,21,-1,1,0,0,0,9.336099585,7.261410788,2.074688797,0,21.78423237,21.78423237
50,4,8,49,11,Utah,Davis County,362679,363492,367285,813,3793,1259,4781,614,2218,645,2563,-2,41,140,1105,138,1146,30,84,2887,2887,2887,13.08470299,6.070251253,7.014451741,0.112209333,3.024178375,3.136387708
50,4,8,49,13,Utah,Duchesne County,19596,19581,19790,-15,209,76,269,41,146,35,123,0,1,-51,81,-51,82,1,4,226,226,226,13.66488024,7.416626451,6.248253791,0.050798811,4.114703716,4.165502527
50,4,8,49,15,Utah,Emery County,9825,9837,9967,12,130,25,114,29,101,-4,13,0,3,16,115,16,118,0,-1,26,26,26,11.51282569,10.1999596,1.312866088,0.302969097,11.61381539,11.91678449
50,4,8,49,17,Utah,Garfield County,5083,5090,5129,7,39,14,52,11,53,3,-1,0,1,6,37,6,38,-2,2,171,171,171,10.17712105,10.37283492,-0.195713866,0.195713866,7.241413054,7.43712692
50,4,8,49,19,Utah,Grand County,9669,9681,9663,12,-18,28,93,18,74,10,19,0,0,1,-35,1,-35,1,-2,107,107,107,9.615384615,7.650951199,1.964433416,0,-3.618693135,-3.618693135
50,4,8,49,21,Utah,Iron County,57289,57640,60519,351,2879,194,804,115,403,79,401,0,7,269,2505,269,2512,3,-34,1107,1107,1107,13.60878139,6.821317039,6.787464349,0.118484415,42.40049425,42.51897866
50,4,8,49,23,Utah,Juab County,11786,11824,12155,38,331,54,174,21,98,33,76,0,1,5,256,5,257,0,-2,65,65,65,14.51269861,8.173818758,6.338879853,0.083406314,21.35201635,21.43542266
50,4,8,49,25,Utah,Kane County,7667,7673,7992,6,319,19,85,24,67,-5,18,0,-1,11,307,11,306,0,-5,226,226,226,10.85221832,8.5541015,2.298116821,-0.127673157,39.19565911,39.06798596
50,4,8,49,27,Utah,Millard County,12975,13015,13164,40,149,45,184,43,131,2,53,0,1,38,95,38,96,0,0,135,135,135,14.05706864,10.0080217,4.049046946,0.076397112,7.257725658,7.33412277
50,4,8,49,29,Utah,Morgan County,12295,12392,12657,97,265,45,124,17,70,28,54,0,1,69,213,69,214,0,-3,0,0,0,9.900594834,5.589045471,4.311549363,0.079843507,17.00666693,17.08651044
50,4,8,49,31,Utah,Piute County,1438,1437,1487,-1,50,4,16,2,14,2,2,0,0,-2,49,-2,49,-1,-1,37,37,37,10.94391245,9.575923393,1.367989056,0,33.51573187,33.51573187
50,4,8,49,33,Utah,Rich County,2510,2504,2597,-6,93,8,30,5,11,3,19,0,0,-9,76,-9,76,0,-2,1,1,1,11.76239953,4.312879828,7.449519702,0,29.79807881,29.79807881
50,4,8,49,35,Utah,Salt Lake County,1185238,1186236,1186421,998,185,3851,15156,2075,8357,1776,6799,54,688,-899,-7447,-845,-6759,67,145,14722,14722,14722,12.77555079,7.044423193,5.731127592,0.579940548,-6.277350666,-5.697410119
50,4,8,49,37,Utah,San Juan County,14518,14525,14489,7,-36,47,154,44,176,3,-22,0,0,4,-18,4,-18,0,4,218,218,218,10.6155649,12.13207417,-1.516509271,0,-1.240780313,-1.240780313
50,4,8,49,39,Utah,Sanpete County,28437,28508,29106,71,598,90,364,70,248,20,116,1,1,49,485,50,486,1,-4,2533,2533,2533,12.63581768,8.609018641,4.026799042,0.034713785,16.83618565,16.87089943
50,4,8,49,41,Utah,Sevier County,21522,21546,21906,24,360,69,273,60,232,9,41,0,0,16,320,16,320,-1,-1,248,248,248,12.56558962,10.67844978,1.887139833,0,14.72889625,14.72889625
50,4,8,49,43,Utah,Summit County,42357,42452,43093,95,641,91,396,38,218,53,178,-2,24,42,441,40,465,2,-2,80,80,80,9.258285113,5.096732714,4.161552399,0.561108189,10.31036297,10.87147116
50,4,8,49,45,Utah,Tooele County,72698,73281,76640,583,3359,246,989,116,424,130,565,0,18,445,2818,445,2836,8,-42,229,229,229,13.1936153,5.656312325,7.53730298,0.240126467,37.59313238,37.83325885
50,4,8,49,47,Utah,Uintah County,35620,35618,36204,-2,586,126,525,94,283,32,242,0,10,-37,330,-37,340,3,4,214,214,214,14.61947593,7.88059369,6.738882237,0.278466208,9.189384868,9.467851076
50,4,8,49,49,Utah,Utah County,659399,663143,684986,3744,21843,3019,11384,865,3128,2154,8256,-8,283,1511,13372,1503,13655,87,-68,14161,14161,14161,16.88859152,4.640505471,12.24808605,0.419841128,19.83786418,20.25770531
50,4,8,49,51,Utah,Wasatch County,34788,35032,36173,244,1141,91,389,50,219,41,170,-1,14,201,967,200,981,3,-10,179,179,179,10.926199,6.151253423,4.77494558,0.393230812,27.16101397,27.55424479
50,4,8,49,53,Utah,Washington County,180279,181924,191226,1645,9302,522,2138,441,1901,81,237,-1,-1,1569,9205,1568,9204,-4,-139,2074,2074,2074,11.45919871,10.18893207,1.270266649,-0.005359775,49.33672786,49.33136808
50,4,8,49,55,Utah,Wayne County,2486,2497,2558,11,61,10,31,11,26,-1,5,0,0,12,56,12,56,0,0,3,3,3,12.26508408,10.28684471,1.978239367,0,22.15628091,22.15628091
50,4,8,49,57,Utah,Weber County,262223,262828,267066,605,4238,876,3514,526,2126,350,1388,-2,3,240,2828,238,2831,17,19,2679,2679,2679,13.26302996,8.024246359,5.238783606,0.011323019,10.67383288,10.6851559
40,1,1,50,0,Vermont,Vermont,643077,642495,645570,-582,3075,1375,5057,1804,6884,-429,-1827,7,275,-119,4589,-112,4864,-41,38,25732,25732,25732,7.85208821,10.68890157,-2.83681336,0.426997085,7.125416807,7.552413892
50,1,1,50,1,Vermont,Addison County,37363,37292,37260,-71,-32,66,279,101,414,-35,-135,0,15,-33,80,-33,95,-3,8,2949,2949,2949,7.48470866,11.10634188,-3.621633222,0.402403691,2.146153021,2.548556712
50,1,1,50,3,Vermont,Bennington County,37347,37271,37312,-76,41,61,285,118,547,-57,-262,0,6,-14,296,-14,302,-5,1,1496,1496,1496,7.642492257,14.66822198,-7.025729724,0.160894574,7.937465642,8.098360216
50,1,1,50,5,Vermont,Caledonia County,30233,30184,30403,-49,219,73,253,97,363,-24,-110,0,2,-23,329,-23,331,-2,-2,1151,1151,1151,8.351626587,11.98276858,-3.631141994,0.066020764,10.8604156,10.92643636
50,1,1,50,7,Vermont,Chittenden County,168323,168289,168865,-34,576,372,1314,387,1358,-15,-44,6,196,-25,390,-19,586,0,34,10184,10184,10184,7.794657634,8.055665957,-0.261008323,1.162673437,2.31348286,3.476156297
50,1,1,50,9,Vermont,Essex County,5920,5910,5925,-10,15,9,37,22,89,-13,-52,0,0,3,68,3,68,0,-1,4,4,4,6.252640473,15.04013519,-8.787494719,0,11.49133925,11.49133925
50,1,1,50,11,Vermont,Franklin County,49946,49996,50325,50,329,136,507,124,490,12,17,1,11,38,295,39,306,-1,6,514,514,514,10.10755475,9.768642657,0.338912092,0.21929606,5.8811216,6.100417659
50,1,1,50,13,Vermont,Grand Isle County,7293,7278,7421,-15,143,18,54,22,65,-4,-11,0,0,-10,156,-10,156,-1,-2,0,0,0,7.347438601,8.844139057,-1.496700456,0,21.22593374,21.22593374
50,1,1,50,15,Vermont,Lamoille County,25945,25914,26126,-31,212,64,237,62,250,2,-13,0,7,-34,218,-34,225,1,0,725,725,725,9.108378171,9.607993851,-0.49961568,0.269023828,8.378170638,8.647194466
50,1,1,50,17,Vermont,Orange County,29277,29259,29541,-18,282,58,228,94,319,-36,-91,0,6,20,369,20,375,-2,-2,633,633,633,7.755102041,10.85034014,-3.095238095,0.204081633,12.55102041,12.75510204
50,1,1,50,19,Vermont,Orleans County,27393,27355,27546,-38,191,65,243,103,356,-38,-113,0,3,4,301,4,304,-4,0,738,738,738,8.852297772,12.96879838,-4.11650061,0.109287627,10.96519189,11.07447952
50,1,1,50,21,Vermont,Rutland County,60572,60455,60591,-117,136,131,413,210,767,-79,-354,0,-1,-31,490,-31,489,-7,1,2224,2224,2224,6.823852089,12.67286817,-5.849016077,-0.016522644,8.096095699,8.079573055
50,1,1,50,23,Vermont,Washington County,59807,59748,59969,-59,221,127,464,170,628,-43,-164,0,2,-11,379,-11,381,-5,4,2958,2958,2958,7.751614224,10.49140891,-2.739794682,0.03341213,6.331598687,6.365010817
50,1,1,50,25,Vermont,Windham County,45905,45844,46090,-61,246,88,330,120,548,-32,-218,0,6,-24,461,-24,467,-5,-3,1415,1415,1415,7.179063241,11.92159593,-4.742532686,0.130528423,10.0289338,10.15946222
50,1,1,50,27,Vermont,Windsor County,57753,57700,58196,-53,496,107,413,174,690,-67,-277,0,22,21,757,21,779,-7,-6,741,741,741,7.127079451,11.90722717,-4.780147719,0.379650721,13.06343618,13.44308691
40,3,5,51,0,Virginia,Virginia,8631393,8632044,8642274,651,10230,23237,93037,20881,84697,2356,8340,574,10930,-2299,-8995,-1725,1935,20,-45,234777,234777,234777,10.77171325,9.806117961,0.965595284,1.265462405,-1.041430406,0.224031999
50,3,5,51,1,Virginia,Accomack County,33413,33348,33246,-65,-102,74,318,134,560,-60,-242,0,32,0,105,0,137,-5,3,407,407,407,9.550409947,16.81833198,-7.267922035,0.961047542,3.153437247,4.114484788
50,3,5,51,3,Virginia,Albemarle County,112395,112496,113535,101,1039,238,991,243,1068,-5,-77,4,140,109,967,113,1107,-7,9,6701,6701,6701,8.768708717,9.45003119,-0.681322473,1.238768134,8.556348466,9.795116599
50,3,5,51,5,Virginia,Alleghany County,15223,15161,14986,-62,-175,22,112,66,276,-44,-164,0,-1,-15,-13,-15,-14,-3,3,259,259,259,7.430258401,18.31027963,-10.88002123,-0.066341593,-0.862440707,-0.9287823
50,3,5,51,7,Virginia,Amelia County,13265,13246,13268,-19,22,30,111,49,195,-19,-84,0,1,2,105,2,106,-2,0,108,108,108,8.372935053,14.70921023,-6.336275175,0.075431847,7.920343969,7.995775817
50,3,5,51,9,Virginia,Amherst County,31307,31262,31273,-45,11,65,291,129,449,-64,-158,0,7,22,159,22,166,-3,3,1270,1270,1270,9.306788199,14.35995842,-5.053170225,0.22387463,5.085152315,5.309026945
50,3,5,51,11,Virginia,Appomattox County,16119,16133,16353,14,220,41,204,59,200,-18,4,0,5,33,212,33,217,-1,-1,40,40,40,12.5592563,12.31299637,0.246259927,0.307824909,13.05177615,13.35960106
50,3,5,51,13,Virginia,Arlington County,238643,238766,232965,123,-5801,658,2489,253,1255,405,1234,45,749,-339,-7685,-294,-6936,12,-99,2667,2667,2667,10.55262427,5.320829032,5.231795239,3.175538601,-32.58212837,-29.40658977
50,3,5,51,15,Virginia,Augusta County,77487,77512,77563,25,51,123,476,258,958,-135,-482,3,26,162,503,165,529,-5,4,2882,2882,2882,6.138965017,12.35531195,-6.216346929,0.335321619,6.487183621,6.822505239
50,3,5,51,17,Virginia,Bath County,4209,4196,4114,-13,-82,17,39,20,60,-3,-21,0,2,-10,-61,-10,-59,0,-2,46,46,46,9.386281588,14.44043321,-5.054151625,0.481347774,-14.6811071,-14.19975933
50,3,5,51,19,Virginia,Bedford County,79462,79504,80131,42,627,135,631,225,1061,-90,-430,0,21,140,1042,140,1063,-8,-6,441,441,441,7.905534501,13.29282426,-5.387289755,0.263100197,13.05478122,13.31788142
50,3,5,51,21,Virginia,Bland County,6270,6247,6173,-23,-74,8,46,26,95,-18,-49,0,0,-5,-25,-5,-25,0,0,650,650,650,7.407407407,15.2979066,-7.890499195,0,-4.025764895,-4.025764895
50,3,5,51,23,Virginia,Botetourt County,33596,33614,33866,18,252,53,227,99,476,-46,-249,0,7,68,499,68,506,-4,-5,237,237,237,6.727919384,14.10788382,-7.379964434,0.20746888,14.78956728,14.99703616
50,3,5,51,25,Virginia,Brunswick County,15849,15806,15940,-43,134,18,122,51,229,-33,-107,0,6,-9,238,-9,244,-1,-3,2070,2070,2070,7.686007686,14.42701443,-6.741006741,0.378000378,14.99401499,15.37201537
50,3,5,51,27,Virginia,Buchanan County,20355,20216,19816,-139,-400,40,156,105,384,-65,-228,0,5,-73,-176,-73,-171,-1,-1,937,937,937,7.793764988,19.18465228,-11.39088729,0.24980016,-8.792965627,-8.543165468
50,3,5,51,29,Virginia,Buckingham County,16824,16820,16947,-4,127,29,141,52,210,-23,-69,0,0,20,197,20,197,-1,-1,2101,2101,2101,8.35134895,12.43817929,-4.086830337,0,11.66819676,11.66819676
50,3,5,51,31,Virginia,Campbell County,55696,55638,55492,-58,-146,124,471,164,691,-40,-220,1,29,-15,34,-14,63,-4,11,399,399,399,8.476558985,12.4358859,-3.959326914,0.521911275,0.611895978,1.133807253
50,3,5,51,33,Virginia,Caroline County,30887,30905,31332,18,427,82,309,84,356,-2,-47,0,6,20,470,20,476,0,-2,453,453,453,9.929784533,11.44014011,-1.510355576,0.19281135,15.10355576,15.29636711
50,3,5,51,35,Virginia,Carroll County,29155,29130,29048,-25,-82,55,242,120,485,-65,-243,2,14,41,145,43,159,-3,2,230,230,230,8.319295954,16.67296916,-8.35367321,0.481281584,4.984702121,5.465983705
50,3,5,51,36,Virginia,Charles City County,6773,6733,6594,-40,-139,11,44,29,132,-18,-88,0,0,-20,-51,-20,-51,-2,0,0,0,0,6.60313649,19.80940947,-13.20627298,0,-7.653635477,-7.653635477
50,3,5,51,37,Virginia,Charlotte County,11529,11506,11448,-23,-58,29,110,54,190,-25,-80,0,1,3,19,3,20,-1,2,115,115,115,9.584386164,16.55484883,-6.970462664,0.087130783,1.655484883,1.742615666
50,3,5,51,41,Virginia,Chesterfield County,364548,365566,370688,1018,5122,944,3770,830,3309,114,461,10,269,894,4402,904,4671,0,-10,4572,4572,4572,10.24103095,8.988745732,1.252285217,0.730726081,11.95782977,12.68855585
50,3,5,51,43,Virginia,Clarke County,14783,14788,14881,5,93,30,135,42,213,-12,-78,-1,2,19,170,18,172,-1,-1,155,155,155,9.100407833,14.35842125,-5.258013415,0.134820857,11.45977283,11.59459368
50,3,5,51,45,Virginia,Craig County,4892,4880,4865,-12,-15,11,35,19,77,-8,-42,0,0,-4,26,-4,26,0,1,9,9,9,7.183170857,15.80297589,-8.619805028,0,5.336069779,5.336069779
50,3,5,51,47,Virginia,Culpeper County,52552,52717,53596,165,879,161,618,145,548,16,70,0,58,149,755,149,813,0,-4,1299,1299,1299,11.62604761,10.30918138,1.316866235,1.091117737,14.20334296,15.2944607
50,3,5,51,49,Virginia,Cumberland County,9675,9656,9681,-19,25,16,86,33,130,-17,-44,0,0,-2,69,-2,69,0,0,17,17,17,8.894864767,13.44572581,-4.550861044,0,7.136577546,7.136577546
50,3,5,51,51,Virginia,Dickenson County,14124,14045,13787,-79,-258,23,112,68,264,-45,-152,0,0,-34,-106,-34,-106,0,0,463,463,463,8.048289738,18.97096867,-10.92267893,0,-7.61713136,-7.61713136
50,3,5,51,53,Virginia,Dinwiddie County,27947,27900,27912,-47,12,35,154,72,367,-37,-213,0,2,-9,223,-9,225,-1,0,677,677,677,5.518526482,13.15129363,-7.632767147,0.071669175,7.991113022,8.062782197
50,3,5,51,57,Virginia,Essex County,10599,10591,10573,-8,-18,30,115,44,147,-14,-32,0,1,7,12,7,13,-1,1,148,148,148,10.86751087,13.89151389,-3.024003024,0.094500095,1.134001134,1.228501229
50,3,5,51,59,Virginia,Fairfax County,1150309,1148472,1139720,-1837,-8752,3186,12792,1541,7071,1645,5721,275,3370,-3813,-17789,-3538,-14419,56,-54,9962,9962,9962,11.18087993,6.180425419,5.000454507,2.945557016,-15.5485204,-12.60296339
50,3,5,51,61,Virginia,Fauquier County,72972,72938,73815,-34,877,174,674,188,709,-14,-35,-1,22,-18,894,-19,916,-1,-4,350,350,350,9.18550217,9.662494123,-0.476991952,0.299823513,12.1837373,12.48356081
50,3,5,51,63,Virginia,Floyd County,15476,15474,15566,-2,92,32,147,36,183,-4,-36,0,1,4,126,4,127,-2,1,56,56,56,9.471649485,11.79123711,-2.319587629,0.06443299,8.118556701,8.182989691
50,3,5,51,65,Virginia,Fluvanna County,27249,27280,27723,31,443,64,210,66,273,-2,-63,0,8,36,502,36,510,-3,-4,1182,1182,1182,7.63594713,9.926731269,-2.290784139,0.290893224,18.25354981,18.54444303
50,3,5,51,67,Virginia,Franklin County,54477,54469,54938,-8,469,121,465,174,776,-53,-311,-1,11,52,776,51,787,-6,-7,975,975,975,8.500370177,14.185564,-5.685193818,0.201084026,14.185564,14.38664802
50,3,5,51,69,Virginia,Frederick County,91419,91766,93717,347,1951,208,893,225,954,-17,-61,1,44,365,1987,366,2031,-2,-19,1113,1113,1113,9.628914779,10.286657,-0.657742219,0.47443701,21.42514408,21.89958109
50,3,5,51,71,Virginia,Giles County,16787,16754,16562,-33,-192,34,144,84,269,-50,-125,0,0,19,-69,19,-69,-2,2,110,110,110,8.644495138,16.14839717,-7.503902029,0,-4.14215392,-4.14215392
50,3,5,51,73,Virginia,Gloucester County,38711,38688,39069,-23,381,84,316,129,499,-45,-183,0,3,25,565,25,568,-3,-4,265,265,265,8.127885592,12.83485731,-4.70697172,0.077163471,14.53245367,14.60961714
50,3,5,51,75,Virginia,Goochland County,24727,24828,25488,101,660,39,188,73,259,-34,-71,0,1,136,738,136,739,-1,-8,955,955,955,7.472772081,10.294936,-2.822163924,0.039748788,29.3346053,29.37435408
50,3,5,51,77,Virginia,Grayson County,15333,15300,15359,-33,59,23,108,50,241,-27,-133,0,3,-3,190,-3,193,-3,-1,978,978,978,7.045239571,15.72132164,-8.676082064,0.195701099,12.39440295,12.59010405
50,3,5,51,79,Virginia,Greene County,20552,20591,20968,39,377,51,218,57,205,-6,13,1,11,44,357,45,368,0,-4,112,112,112,10.49110903,9.865492432,0.625616593,0.529367887,17.18039414,17.70976203
50,3,5,51,81,Virginia,Greensville County,11391,11393,11437,2,44,29,106,32,140,-3,-34,0,0,5,77,5,77,0,1,3457,3457,3457,9.286027157,12.26456417,-2.978537013,0,6.745510294,6.745510294
50,3,5,51,83,Virginia,Halifax County,34022,33901,33738,-121,-163,104,347,165,585,-61,-238,0,3,-55,67,-55,70,-5,5,674,674,674,10.26035276,17.29771286,-7.037360103,0.08870622,1.981105575,2.069811795
50,3,5,51,85,Virginia,Hanover County,109979,110102,111603,123,1501,239,869,303,1140,-64,-271,0,37,192,1747,192,1784,-5,-12,1892,1892,1892,7.839245845,10.28393586,-2.444690016,0.333776866,15.75968066,16.09345752
50,3,5,51,87,Virginia,Henrico County,334389,334298,333554,-91,-744,898,3536,809,3404,89,132,39,635,-218,-1552,-179,-917,-1,41,2504,2504,2504,10.58917245,10.19387529,0.395297162,1.901618922,-4.647736325,-2.746117403
50,3,5,51,89,Virginia,Henry County,50948,50782,50248,-166,-534,90,362,234,862,-144,-500,1,-1,-18,-40,-17,-41,-5,7,501,501,501,7.166188261,17.06423835,-9.898050084,-0.0197961,-0.791844007,-0.811640107
50,3,5,51,91,Virginia,Highland County,2232,2236,2226,4,-10,2,18,8,39,-6,-21,0,0,10,11,10,11,0,0,0,0,0,8.068130883,17.48095025,-9.412819364,0,4.930524429,4.930524429
50,3,5,51,93,Virginia,Isle of Wight County,38606,38658,39278,52,620,90,326,124,458,-34,-132,2,37,87,724,89,761,-3,-9,270,270,270,8.365838637,11.75323342,-3.387394785,0.949497023,18.57934716,19.52884418
50,3,5,51,95,Virginia,James City County,78254,78412,79882,158,1470,193,727,220,851,-27,-124,0,50,197,1561,197,1611,-12,-17,1054,1054,1054,9.185439751,10.75214474,-1.566704992,0.631735884,19.72279429,20.35453018
50,3,5,51,97,Virginia,King and Queen County,6608,6590,6662,-18,72,21,63,32,121,-11,-58,0,0,-6,132,-6,132,-1,-2,0,0,0,9.507998793,18.26139451,-8.753395714,0,19.92152128,19.92152128
50,3,5,51,99,Virginia,King George County,26723,26806,27489,83,683,71,285,58,211,13,74,1,4,68,613,69,617,1,-8,212,212,212,10.49820426,7.772354729,2.725849526,0.147343218,22.5803481,22.72769132
50,3,5,51,101,Virginia,King William County,17810,17905,18171,95,266,38,187,46,190,-8,-3,0,3,102,267,102,270,1,-1,57,57,57,10.36700299,10.53331855,-0.166315556,0.166315556,14.80208449,14.96840004
50,3,5,51,103,Virginia,Lancaster County,10919,10910,10928,-9,18,22,70,59,241,-37,-171,0,0,31,190,31,190,-3,-1,165,165,165,6.410843484,22.07161828,-15.6607748,0,17.40086089,17.40086089
50,3,5,51,105,Virginia,Lee County,22173,22084,21983,-89,-101,42,193,80,403,-38,-210,0,-1,-49,109,-49,108,-2,1,1313,1313,1313,8.759389112,18.29033063,-9.530941521,-0.045385436,4.947012504,4.901627068
50,3,5,51,107,Virginia,Loudoun County,420959,422597,427592,1638,4995,1235,4654,490,2046,745,2608,53,643,803,1651,856,2294,37,93,1463,1463,1463,10.94815388,4.813047452,6.135106429,1.512604844,3.883842299,5.396447143
50,3,5,51,109,Virginia,Louisa County,37596,37757,38848,161,1091,100,352,111,465,-11,-113,-1,12,174,1208,173,1220,-1,-16,126,126,126,9.190000653,12.14019973,-2.950199073,0.313295477,31.53841133,31.85170681
50,3,5,51,111,Virginia,Lunenburg County,11936,11930,11926,-6,-4,24,103,46,207,-22,-104,0,16,17,84,17,100,-1,0,938,938,938,8.635144199,17.35412475,-8.71898055,1.341381623,7.042253521,8.383635144
50,3,5,51,113,Virginia,Madison County,13837,13837,13942,0,105,28,133,54,143,-26,-10,-1,6,27,109,26,115,0,0,184,184,184,9.575578675,10.295547,-0.719968321,0.431980993,7.847654703,8.279635696
50,3,5,51,115,Virginia,Mathews County,8533,8524,8546,-9,22,15,68,36,151,-21,-83,0,0,14,104,14,104,-2,1,55,55,55,7.967193907,17.69185706,-9.724663152,0,12.18512009,12.18512009
50,3,5,51,117,Virginia,Mecklenburg County,30319,30287,30248,-32,-39,80,269,139,565,-59,-296,0,19,33,236,33,255,-6,2,796,796,796,8.887420501,18.66688693,-9.779466424,0.627736021,7.797142149,8.42487817
50,3,5,51,119,Virginia,Middlesex County,10625,10623,10781,-2,158,21,86,42,188,-21,-102,0,3,21,260,21,263,-2,-3,349,349,349,8.035881144,17.56680994,-9.530928798,0.280321435,24.29452439,24.57484582
50,3,5,51,121,Virginia,Montgomery County,99721,99508,98473,-213,-1035,189,686,195,796,-6,-110,11,145,-224,-1075,-213,-930,6,5,9932,9932,9932,6.929957925,8.041175668,-1.111217743,1.464787025,-10.85962794,-9.394840919
50,3,5,51,125,Virginia,Nelson County,14775,14732,14790,-43,58,38,124,61,208,-23,-84,0,2,-16,141,-16,143,-4,-1,84,84,84,8.40051487,14.09118623,-5.690671364,0.135492175,9.552198361,9.687690536
50,3,5,51,127,Virginia,New Kent County,22945,23086,23897,141,811,44,214,62,239,-18,-25,0,2,158,845,158,847,1,-11,462,462,462,9.109677969,10.17389269,-1.064214716,0.085137177,35.9704574,36.05559458
50,3,5,51,131,Virginia,Northampton County,12282,12232,12085,-50,-147,20,105,53,212,-33,-107,0,4,-14,-44,-14,-40,-3,0,245,245,245,8.635933709,17.43636139,-8.800427684,0.328987951,-3.618867459,-3.289879508
50,3,5,51,133,Virginia,Northumberland County,11839,11839,12029,0,190,24,104,54,258,-30,-154,0,0,34,350,34,350,-4,-6,0,0,0,8.71459695,21.61890397,-12.90430702,0,29.3279705,29.3279705
50,3,5,51,135,Virginia,Nottoway County,15642,15614,15594,-28,-20,32,176,63,218,-31,-42,0,4,3,18,3,22,0,0,2256,2256,2256,11.27915919,13.97077672,-2.691617534,0.256344527,1.153550372,1.409894899
50,3,5,51,137,Virginia,Orange County,36254,36396,37188,142,792,79,400,119,461,-40,-61,1,14,182,849,183,863,-1,-10,451,451,451,10.87192868,12.5298978,-1.657969124,0.380517504,23.07566862,23.45618613
50,3,5,51,139,Virginia,Page County,23709,23693,23807,-16,114,64,237,97,369,-33,-132,0,4,19,241,19,245,-2,1,131,131,131,9.978947368,15.53684211,-5.557894737,0.168421053,10.14736842,10.31578947
50,3,5,51,141,Virginia,Patrick County,17608,17560,17602,-48,42,29,84,77,305,-48,-221,0,0,4,266,4,266,-4,-3,255,255,255,4.777885217,17.34827371,-12.57038849,0,15.12996985,15.12996985
50,3,5,51,143,Virginia,Pittsylvania County,60501,60312,59972,-189,-340,113,493,220,922,-107,-429,0,6,-76,76,-76,82,-6,7,1002,1002,1002,8.197266469,15.33038476,-7.133118287,0.099763892,1.263675967,1.363439859
50,3,5,51,145,Virginia,Powhatan County,30333,30433,31136,100,703,65,249,76,311,-11,-62,0,2,112,772,112,774,-1,-9,1097,1097,1097,8.088486089,10.10248664,-2.014000552,0.06496776,25.07755526,25.14252302
50,3,5,51,147,Virginia,Prince Edward County,21849,21853,21932,4,79,50,224,90,265,-40,-41,0,21,44,96,44,117,0,3,3686,3686,3686,10.23181455,12.10460203,-1.872787484,0.959232614,4.385063378,5.344295992
50,3,5,51,149,Virginia,Prince George County,43010,43023,42880,13,-143,76,305,84,320,-8,-15,4,-9,16,-127,20,-136,1,8,4349,4349,4349,7.10103256,7.45026367,-0.34923111,-0.209538666,-2.956823394,-3.16636206
50,3,5,51,153,Virginia,Prince William County,482204,482738,484472,534,1734,1525,6080,595,2597,930,3483,59,980,-496,-2824,-437,-1844,41,95,2932,2932,2932,12.57224388,5.37008509,7.202158787,2.026447204,-5.839476432,-3.813029228
50,3,5,51,155,Virginia,Pulaski County,33800,33760,33759,-40,-1,79,289,152,539,-73,-250,0,2,37,246,37,248,-4,1,1008,1008,1008,8.560553326,15.96587627,-7.405322946,0.059242584,7.286837779,7.346080363
50,3,5,51,157,Virginia,Rappahannock County,7348,7312,7407,-36,95,10,45,22,88,-12,-43,0,-1,-22,140,-22,139,-2,-1,32,32,32,6.114545825,11.95733406,-5.842788233,-0.135878796,19.02303146,18.88715266
50,3,5,51,159,Virginia,Richmond County,8923,8920,9017,-3,97,12,65,24,129,-12,-64,0,4,10,159,10,163,-1,-2,1579,1579,1579,7.247588783,14.3836762,-7.136087417,0.446005464,17.72871718,18.17472264
50,3,5,51,161,Virginia,Roanoke County,96929,96845,96589,-84,-256,162,652,310,1157,-148,-505,0,41,74,192,74,233,-10,16,2299,2299,2299,6.741317452,11.96273664,-5.221419192,0.423917202,1.985173237,2.409090439
50,3,5,51,163,Virginia,Rockbridge County,22650,22610,22641,-40,31,28,108,87,283,-59,-175,1,2,21,206,22,208,-3,-2,452,452,452,4.773375174,12.50801087,-7.734635699,0.088395837,9.104771165,9.193167002
50,3,5,51,165,Virginia,Rockingham County,83757,83758,84394,1,636,191,821,206,929,-15,-108,0,61,21,680,21,741,-5,3,1610,1610,1610,9.764974547,11.04952662,-1.284552072,0.725534041,8.087920453,8.813454494
50,3,5,51,167,Virginia,Russell County,25781,25726,25550,-55,-176,63,256,120,429,-57,-173,0,1,3,-6,3,-5,-1,2,311,311,311,9.985178251,16.73297449,-6.74779624,0.039004603,-0.234027615,-0.195023013
50,3,5,51,169,Virginia,Scott County,21576,21547,21419,-29,-128,33,148,100,397,-67,-249,0,4,41,116,41,120,-3,1,729,729,729,6.88916818,18.47972816,-11.59055998,0.186193735,5.399618303,5.585812037
50,3,5,51,171,Virginia,Shenandoah County,44186,44255,44752,69,497,106,475,129,643,-23,-168,0,24,96,645,96,669,-4,-4,373,373,373,10.67331783,14.44830182,-3.77498399,0.539283427,14.49324211,15.03252553
50,3,5,51,173,Virginia,Smyth County,29800,29730,29477,-70,-253,55,219,152,554,-97,-335,0,6,31,73,31,79,-4,3,689,689,689,7.397773912,18.71400341,-11.3162295,0.202678737,2.465924637,2.668603375
50,3,5,51,175,Virginia,Southampton County,17996,17949,18006,-47,57,31,103,52,249,-21,-146,0,1,-26,205,-26,206,0,-3,1562,1562,1562,5.729383952,13.85064664,-8.121262689,0.055625087,11.40314282,11.4587679
50,3,5,51,177,Virginia,Spotsylvania County,140032,140475,143676,443,3201,344,1541,281,1242,63,299,1,64,377,2861,378,2925,2,-23,449,449,449,10.84634578,8.741830928,2.104514853,0.450464718,20.13718058,20.5876453
50,3,5,51,179,Virginia,Stafford County,156927,157604,160877,677,3273,424,1688,270,1025,154,663,-3,45,518,2583,515,2628,8,-18,4256,4256,4256,10.60031839,6.436804707,4.163513679,0.282591426,16.22074786,16.50333929
50,3,5,51,181,Virginia,Surry County,6561,6546,6530,-15,-16,12,63,25,78,-13,-15,0,-1,-1,0,-1,-1,-1,0,0,0,0,9.635974304,11.9302539,-2.294279596,-0.152951973,0,-0.152951973
50,3,5,51,183,Virginia,Sussex County,10829,10768,10763,-61,-5,13,80,51,160,-38,-80,0,1,-24,74,-24,75,1,0,2515,2515,2515,7.43114579,14.86229158,-7.43114579,0.092889322,6.873809856,6.966699178
50,3,5,51,185,Virginia,Tazewell County,40429,40343,39925,-86,-418,78,366,173,793,-95,-427,0,6,13,-3,13,3,-4,6,1675,1675,1675,9.119449843,19.75880799,-10.63935815,0.149499178,-0.074749589,0.074749589
50,3,5,51,187,Virginia,Warren County,40727,40782,40925,55,143,126,493,107,507,19,-14,-1,17,36,134,35,151,1,6,627,627,627,12.06750952,12.41019741,-0.342687897,0.416121018,3.280012728,3.696133746
50,3,5,51,191,Virginia,Washington County,53935,53839,53635,-96,-204,121,417,218,864,-97,-447,0,6,7,232,7,238,-6,5,1728,1728,1728,7.760016376,16.07830731,-8.318290935,0.111654912,4.31732326,4.428978172
50,3,5,51,193,Virginia,Westmoreland County,18477,18496,18731,19,235,53,166,81,262,-28,-96,-2,0,51,334,49,334,-2,-3,55,55,55,8.918258253,14.0758052,-5.157546942,0,17.9439654,17.9439654
50,3,5,51,195,Virginia,Wise County,36130,36018,35647,-112,-371,100,345,183,600,-83,-255,0,-3,-27,-118,-27,-121,-2,5,2712,2712,2712,9.628130887,16.74457546,-7.116444568,-0.083722877,-3.29309984,-3.376822717
50,3,5,51,197,Virginia,Wythe County,28290,28274,28178,-16,-96,67,252,116,449,-49,-197,0,-2,35,99,35,97,-2,4,188,188,188,8.92793878,15.90731949,-6.979380713,-0.070856657,3.507404521,3.436547864
50,3,5,51,199,Virginia,York County,70045,70154,70915,109,761,135,550,147,646,-12,-96,4,43,117,818,121,861,0,-4,599,599,599,7.797602592,9.15863868,-1.361036089,0.609630748,11.59716167,12.20679242
50,3,5,51,510,Virginia,Alexandria city,159467,159097,154706,-370,-4391,596,2336,204,1046,392,1290,28,608,-797,-6188,-769,-5580,7,-101,1655,1655,1655,14.88832165,6.666602932,8.221718722,3.875042622,-39.43875616,-35.56371354
50,3,5,51,520,Virginia,Bristol city,17219,17259,17054,40,-205,31,141,71,270,-40,-129,-1,0,82,-77,81,-77,-1,1,188,188,188,8.218459476,15.73747559,-7.519016116,0,-4.488094891,-4.488094891
50,3,5,51,530,Virginia,Buena Vista city,6641,6620,6601,-21,-19,24,75,24,97,0,-22,0,2,-21,1,-21,3,0,0,493,493,493,11.34558657,14.67362529,-3.328038726,0.302548975,0.151274488,0.453823463
50,3,5,51,540,Virginia,Charlottesville city,46553,46423,45672,-130,-751,139,593,89,329,50,264,2,114,-184,-1116,-182,-1002,2,-13,2244,2244,2244,12.87800641,7.144796134,5.733210272,2.475704436,-24.23584342,-21.76013899
50,3,5,51,550,Virginia,Chesapeake city,249422,249679,251269,257,1590,715,2782,605,2398,110,384,-5,153,147,1014,142,1167,5,39,4222,4222,4222,11.10694124,9.573847984,1.533093255,0.610841844,4.048324377,4.659166221
50,3,5,51,570,Virginia,Colonial Heights city,18170,18191,18273,21,82,67,264,70,236,-3,28,0,5,24,49,24,54,0,0,165,165,165,14.4800351,12.9442738,1.535761299,0.274243089,2.687582273,2.961825362
50,3,5,51,580,Virginia,Covington city,5737,5721,5717,-16,-4,16,64,31,72,-15,-8,0,3,0,0,0,3,-1,1,87,87,87,11.19076762,12.58961357,-1.398845952,0.524567232,0,0.524567232
50,3,5,51,590,Virginia,Danville city,42590,42465,42215,-125,-250,101,411,235,779,-134,-368,-1,20,13,92,12,112,-3,6,1593,1593,1593,9.707132735,18.39867737,-8.691544639,0.472366556,2.17288616,2.645252716
50,3,5,51,595,Virginia,Emporia city,5766,5716,5667,-50,-49,14,59,26,86,-12,-27,0,-1,-37,-22,-37,-23,-1,1,242,242,242,10.36633576,15.11025213,-4.743916367,-0.175700606,-3.865413336,-4.041113942
50,3,5,51,600,Virginia,Fairfax city,24146,24129,24276,-17,147,150,602,91,263,59,339,0,100,-77,-290,-77,-190,1,-2,497,497,497,24.87346349,10.86664601,14.00681748,4.131804566,-11.98223324,-7.850428675
50,3,5,51,610,Virginia,Falls Church city,14658,14654,14493,-4,-161,43,185,42,130,1,55,0,16,-5,-231,-5,-215,0,-1,35,35,35,12.69427385,8.920300546,3.773973308,1.097883144,-15.85068789,-14.75280475
50,3,5,51,620,Virginia,Franklin city,8180,8171,8217,-9,46,41,156,36,115,5,41,0,0,-14,5,-14,5,0,0,124,124,124,19.03832072,14.03465951,5.003661216,0,0.610202587,0.610202587
50,3,5,51,630,Virginia,Fredericksburg city,27982,27995,28367,13,372,82,355,69,285,13,70,1,77,-2,223,-1,300,1,2,2377,2377,2377,12.59713992,10.11319684,2.483943082,2.73233739,7.913132962,10.64547035
50,3,5,51,640,Virginia,Galax city,6720,6691,6660,-29,-31,21,97,43,115,-22,-18,-1,2,-6,-16,-7,-14,0,1,371,371,371,14.53074676,17.22717399,-2.696427234,0.299603026,-2.396824208,-2.097221182
50,3,5,51,650,Virginia,Hampton city,137148,137131,137746,-17,615,389,1523,409,1476,-20,47,1,47,2,499,3,546,0,22,4857,4857,4857,11.08132001,10.73934887,0.341971136,0.341971136,3.630714829,3.972685965
50,3,5,51,660,Virginia,Harrisonburg city,51814,51675,51430,-139,-245,145,593,91,342,54,251,4,192,-202,-686,-198,-494,5,-2,7324,7324,7324,11.50283691,6.634013869,4.868823045,3.724358664,-13.30682314,-9.582464478
50,3,5,51,670,Virginia,Hopewell city,23033,22967,23140,-66,173,91,321,105,316,-14,5,1,21,-53,146,-52,167,0,1,215,215,215,13.924133,13.70724619,0.216886807,0.910924589,6.333094758,7.244019346
50,3,5,51,678,Virginia,Lexington city,7320,7313,7456,-7,143,22,117,31,72,-9,45,0,3,2,95,2,98,0,0,2762,2762,2762,15.84399756,9.750152346,6.093845216,0.406256348,12.86478435,13.27104069
50,3,5,51,680,Virginia,Lynchburg city,79009,78871,79009,-138,138,267,1077,248,899,19,178,3,111,-162,-160,-159,-49,2,9,10459,10459,10459,13.64327337,11.38839625,2.254877122,1.406131239,-2.02685584,-0.620724601
50,3,5,51,683,Virginia,Manassas city,42772,42728,42708,-44,-20,178,665,59,268,119,397,1,97,-167,-514,-166,-417,3,0,46,46,46,15.5672082,6.273701952,9.29350625,2.270705557,-12.03239852,-9.761692963
50,3,5,51,685,Virginia,Manassas Park city,17219,17140,17002,-79,-138,6,35,22,72,-16,-37,1,44,-67,-148,-66,-104,3,3,3,3,3,2.050260676,4.217679105,-2.167418429,2.577470564,-8.669673716,-6.092203152
50,3,5,51,690,Virginia,Martinsville city,13485,13422,13517,-63,95,56,253,107,262,-51,-9,0,5,-13,99,-13,104,1,0,376,376,376,18.78317681,19.45135306,-0.66817625,0.371209028,7.349938751,7.721147778
50,3,5,51,700,Virginia,Newport News city,186247,185916,184587,-331,-1329,665,2630,485,1888,180,742,5,230,-523,-2293,-518,-2063,7,-8,8125,8125,8125,14.19691608,10.19155041,4.005365679,1.241555399,-12.37776752,-11.13621212
50,3,5,51,710,Virginia,Norfolk city,238005,237591,235089,-414,-2502,758,3241,602,2440,156,801,3,264,-583,-3540,-580,-3276,10,-27,32813,32813,32813,13.71329441,10.32410933,3.389185072,1.11703478,-14.97842092,-13.86138614
50,3,5,51,720,Virginia,Norton city,3687,3679,3666,-8,-13,9,45,14,49,-5,-4,0,2,-3,-12,-3,-10,0,1,31,31,31,12.25323349,13.3424098,-1.08917631,0.544588155,-3.267528931,-2.722940776
50,3,5,51,730,Virginia,Petersburg city,33458,33428,33429,-30,1,169,660,138,570,31,90,2,2,-63,-95,-61,-93,0,4,893,893,893,19.74363193,17.05131849,2.692313445,0.059829188,-2.841886414,-2.782057227
50,3,5,51,735,Virginia,Poquoson city,12460,12455,12574,-5,119,19,97,37,139,-18,-42,0,1,13,162,13,163,0,-2,37,37,37,7.75100883,11.10711575,-3.356106916,0.079907308,12.94498382,13.02489113
50,3,5,51,740,Virginia,Portsmouth city,97915,98015,97840,100,-175,346,1414,256,1203,90,211,0,51,9,-451,9,-400,1,14,2987,2987,2987,14.43925353,12.2845983,2.15465523,0.520793444,-4.605447908,-4.084654464
50,3,5,51,750,Virginia,Radford city,16070,16089,16499,19,410,29,123,39,116,-10,7,0,3,28,404,28,407,1,-4,3000,3000,3000,7.548790966,7.119184976,0.42960599,0.184116853,24.79440285,24.9785197
50,3,5,51,760,Virginia,Richmond city,226610,226670,226604,60,-66,705,2999,639,2544,66,455,7,362,-20,-887,-13,-525,7,4,11976,11976,11976,13.23261427,11.22499857,2.007615703,1.597267878,-3.913747535,-2.316479657
50,3,5,51,770,Virginia,Roanoke city,100011,99875,98865,-136,-1010,340,1425,341,1391,-1,34,9,131,-141,-1169,-132,-1038,-3,-6,1986,1986,1986,14.34034417,13.99818859,0.34215558,1.318305324,-11.76411392,-10.44580859
50,3,5,51,775,Virginia,Salem city,25346,25374,25373,28,-1,78,264,106,377,-28,-113,-1,12,59,96,58,108,-2,4,1942,1942,1942,10.40455593,14.85802116,-4.453465229,0.472934361,3.783474885,4.256409246
50,3,5,51,790,Virginia,Staunton city,25750,25800,25661,50,-139,95,350,104,388,-9,-38,1,32,59,-133,60,-101,-1,0,969,969,969,13.60253396,15.0793805,-1.476846544,1.243660248,-5.168962904,-3.925302656
50,3,5,51,800,Virginia,Suffolk city,94324,94685,96194,361,1509,264,1096,254,995,10,101,0,29,347,1381,347,1410,4,-2,899,899,899,11.48371481,10.42545277,1.05826204,0.303857418,14.46989978,14.7737572
50,3,5,51,810,Virginia,Virginia Beach city,459470,459373,457672,-97,-1701,1321,5156,934,4164,387,992,8,280,-500,-3022,-492,-2742,8,49,9530,9530,9530,11.2448135,9.081342791,2.163470713,0.610657056,-6.59073437,-5.980077314
50,3,5,51,820,Virginia,Waynesboro city,22196,22279,22550,83,271,90,323,65,327,25,-4,0,29,58,247,58,276,0,-1,119,119,119,14.41031475,14.58877066,-0.17845591,1.293805349,11.01965246,12.31345781
50,3,5,51,830,Virginia,Williamsburg city,15425,15445,15590,20,145,17,78,55,146,-38,-68,0,17,57,196,57,213,1,0,4333,4333,4333,5.02658289,9.408732077,-4.382149186,1.095537297,12.6309006,13.72643789
50,3,5,51,840,Virginia,Winchester city,28120,28008,28136,-112,128,87,345,68,294,19,51,-2,48,-129,22,-131,70,0,7,1051,1051,1051,12.28982616,10.47306925,1.816756911,1.709888857,0.78369906,2.493587917
40,4,9,53,0,Washington,Washington,7705281,7718785,7738692,13504,19907,21077,81193,17643,70836,3434,10357,554,9233,9437,-29,9991,9204,79,346,143604,143604,143604,10.50533667,9.16527322,1.340063453,1.194632216,-0.003752229,1.190879986
50,4,9,53,1,Washington,Adams County,20613,20605,20621,-8,16,84,352,28,142,56,210,4,49,-68,-246,-64,-197,0,3,149,149,149,17.07660214,6.888856547,10.1877456,2.377140639,-11.93421627,-9.557075632
50,4,9,53,3,Washington,Asotin County,22285,22290,22397,5,107,47,223,88,325,-41,-102,0,2,48,207,48,209,-2,0,112,112,112,9.980531251,14.54561729,-4.565086043,0.089511491,9.264439322,9.353950813
50,4,9,53,5,Washington,Benton County,206873,207230,210025,357,2795,604,2447,522,1926,82,521,5,100,267,2166,272,2266,3,8,1285,1285,1285,11.7290386,9.231764748,2.497273849,0.479323196,10.38214042,10.86146361
50,4,9,53,7,Washington,Chelan County,79074,79185,79646,111,461,202,815,192,817,10,-2,3,-2,102,460,105,458,-4,5,881,881,881,10.26248025,10.28766425,-0.025184001,-0.025184001,5.792320139,5.767136138
50,4,9,53,9,Washington,Clallam County,77155,77280,78209,125,929,146,575,288,1227,-142,-652,3,35,277,1566,280,1601,-13,-20,1668,1668,1668,7.396021584,15.78246693,-8.386445343,0.450192618,20.142904,20.59309662
50,4,9,53,11,Washington,Clark County,503311,505013,511404,1702,6391,1374,5332,1184,4708,190,624,9,223,1494,5515,1503,5738,9,29,3319,3319,3319,10.49175683,9.263914319,1.22784251,0.438796281,10.85184526,11.29064154
50,4,9,53,13,Washington,Columbia County,3952,3949,4042,-3,93,10,33,20,43,-10,-10,1,9,8,94,9,103,-2,0,49,49,49,8.259291703,10.76210737,-2.502815668,2.252534101,23.52646728,25.77900138
50,4,9,53,15,Washington,Cowlitz County,110730,110924,111524,194,600,332,1186,380,1388,-48,-202,2,22,244,770,246,792,-4,10,1073,1073,1073,10.66316622,12.47932101,-1.816154787,0.197799036,6.922966266,7.120765303
50,4,9,53,17,Washington,Douglas County,42938,42998,43696,60,698,131,469,98,396,33,73,3,38,24,589,27,627,0,-2,136,136,136,10.81966457,9.135580317,1.68408425,0.876646596,13.58802224,14.46466884
50,4,9,53,19,Washington,Ferry County,7178,7178,7273,0,95,15,68,38,91,-23,-23,0,0,24,120,24,120,-1,-2,194,194,194,9.411113418,12.59428413,-3.183170715,0,16.60784721,16.60784721
50,4,9,53,21,Washington,Franklin County,96749,97076,98268,327,1192,361,1481,160,578,201,903,8,131,109,134,117,265,9,24,2733,2733,2733,15.16299451,5.917765583,9.24522893,1.341223687,1.371938734,2.713162421
50,4,9,53,23,Washington,Garfield County,2286,2292,2346,6,54,7,18,7,24,0,-6,0,0,7,61,7,61,-1,-1,29,29,29,7.761966365,10.34928849,-2.587322122,0,26.30444157,26.30444157
50,4,9,53,25,Washington,Grant County,99123,99365,100297,242,932,359,1329,227,885,132,444,18,86,89,382,107,468,3,20,1124,1124,1124,13.31249812,8.864981819,4.447516303,0.86145586,3.826466729,4.687922589
50,4,9,53,27,Washington,Grays Harbor County,75636,75811,76841,175,1030,168,694,267,1077,-99,-383,0,-4,278,1428,278,1424,-4,-11,2613,2613,2613,9.092576579,14.1105259,-5.017949323,-0.052406781,18.70922097,18.65681419
50,4,9,53,29,Washington,Island County,86857,86948,87432,91,484,202,791,237,905,-35,-114,1,16,137,588,138,604,-12,-6,1933,1933,1933,9.072141301,10.37963069,-1.307489391,0.183507283,6.743892648,6.927399931
50,4,9,53,31,Washington,Jefferson County,32977,33048,33605,71,557,36,164,108,473,-72,-309,0,16,152,863,152,879,-9,-13,596,596,596,4.921008807,14.19290955,-9.27190074,0.48009842,25.89530854,26.37540696
50,4,9,53,33,Washington,King County,2269675,2272571,2252305,2896,-20266,5932,23082,4062,16444,1870,6638,296,5984,632,-32802,928,-26818,98,-86,39336,39336,39336,10.20226853,7.268265473,2.934003053,2.644934358,-14.49851885,-11.8535845
50,4,9,53,35,Washington,Kitsap County,275611,275660,274314,49,-1346,723,2755,662,2832,61,-77,-4,42,3,-1331,-1,-1289,-11,20,9379,9379,9379,10.01865543,10.29866866,-0.280013237,0.152734493,-4.840228811,-4.687494318
50,4,9,53,37,Washington,Kittitas County,44337,44589,45499,252,910,96,381,90,402,6,-21,0,19,245,917,245,936,1,-5,2423,2423,2423,8.458396235,8.924607051,-0.466210816,0.421809786,20.3578723,20.77968209
50,4,9,53,39,Washington,Klickitat County,22735,22783,23118,48,335,47,196,67,256,-20,-60,1,11,69,388,70,399,-2,-4,174,174,174,8.540118952,11.15444108,-2.614322128,0.47929239,16.90594976,17.38524215
50,4,9,53,41,Washington,Lewis County,82149,82474,84398,325,1924,221,900,277,1107,-56,-207,0,37,385,2122,385,2159,-4,-28,821,821,821,10.78671077,13.26765425,-2.480943478,0.443453665,25.43266695,25.87612062
50,4,9,53,43,Washington,Lincoln County,10876,10920,11232,44,312,30,95,28,160,2,-65,0,1,44,382,44,383,-2,-6,68,68,68,8.577103648,14.44564825,-5.868544601,0.090285302,34.48898519,34.5792705
50,4,9,53,45,Washington,Mason County,65726,66028,67615,302,1587,179,644,199,832,-20,-188,2,59,324,1737,326,1796,-4,-21,2335,2335,2335,9.637616635,12.45108236,-2.813465726,0.88294935,25.99462748,26.87757683
50,4,9,53,47,Washington,Okanogan County,42104,42118,42634,14,516,114,422,140,555,-26,-133,4,48,41,603,45,651,-5,-2,504,504,504,9.958467057,13.09703606,-3.138569001,1.132716632,14.22975269,15.36246932
50,4,9,53,49,Washington,Pacific County,23365,23470,23948,105,478,33,167,79,399,-46,-232,2,31,153,689,155,720,-4,-10,261,261,261,7.043738665,16.82905226,-9.785313594,1.307520351,29.06069425,30.3682146
50,4,9,53,51,Washington,Pend Oreille County,13401,13482,13886,81,404,17,123,50,201,-33,-78,0,3,116,488,116,491,-2,-9,61,61,61,8.988599825,14.68868752,-5.700087694,0.219234142,35.66208711,35.88132125
50,4,9,53,53,Washington,Pierce County,921130,922828,925708,1698,2880,2784,10690,2125,8582,659,2108,40,450,969,138,1009,588,30,184,20421,20421,20421,11.56590946,9.285185682,2.280723773,0.486871773,0.149307344,0.636179117
50,4,9,53,55,Washington,San Juan County,17788,17818,18557,30,739,28,96,38,174,-10,-78,0,4,44,827,44,831,-4,-14,126,126,126,5.278350516,9.567010309,-4.288659794,0.219931272,45.47079038,45.69072165
50,4,9,53,57,Washington,Skagit County,129523,129852,130696,329,844,341,1340,339,1555,2,-215,17,131,318,921,335,1052,-8,7,1451,1451,1451,10.28601256,11.93638025,-1.650367687,1.00557287,7.069714602,8.075287471
50,4,9,53,59,Washington,Skamania County,12036,12034,12170,-2,136,19,80,24,126,-5,-46,0,6,4,179,4,185,-1,-3,18,18,18,6.610477607,10.41150223,-3.801024624,0.495785821,14.79094365,15.28672947
50,4,9,53,61,Washington,Snohomish County,827957,829331,833540,1374,4209,2381,9152,1768,7163,613,1989,87,886,647,1175,734,2061,27,159,9863,9863,9863,11.00746841,8.615220303,2.392248106,1.065626859,1.413218464,2.478845322
50,4,9,53,63,Washington,Spokane County,539339,540700,546040,1361,5340,1517,5509,1452,5802,65,-293,-1,113,1295,5491,1294,5604,2,29,14355,14355,14355,10.13857961,10.67780702,-0.539227414,0.207961426,10.10545301,10.31341443
50,4,9,53,65,Washington,Stevens County,46445,46566,47426,121,860,120,372,159,606,-39,-234,0,3,166,1107,166,1110,-6,-16,214,214,214,7.915567282,12.89471444,-4.979147161,0.06383522,23.55519619,23.61903141
50,4,9,53,67,Washington,Thurston County,294793,295729,297977,936,2248,758,2904,729,2818,29,86,0,65,912,2064,912,2129,-5,33,3898,3898,3898,9.78261968,9.492914001,0.289705679,0.218963595,6.952936302,7.171899897
50,4,9,53,69,Washington,Wahkiakum County,4422,4443,4582,21,139,6,28,11,55,-5,-27,0,1,27,166,27,167,-1,-1,14,14,14,6.20498615,12.18836565,-5.983379501,0.221606648,36.7867036,37.00831025
50,4,9,53,71,Washington,Walla Walla County,62584,62574,62682,-10,108,133,576,183,700,-50,-124,5,55,37,167,42,222,-2,10,4669,4669,4669,9.197164208,11.17710928,-1.979945072,0.878201443,2.666538928,3.544740372
50,4,9,53,73,Washington,Whatcom County,226847,227304,228831,457,1527,511,1934,501,2098,10,-164,11,156,441,1512,452,1668,-5,23,5529,5529,5529,8.47994563,9.199030989,-0.719085359,0.684008024,6.629616232,7.313624256
50,4,9,53,75,Washington,Whitman County,47973,47786,47873,-187,87,115,329,78,317,37,12,4,143,-233,-75,-229,68,5,7,6435,6435,6435,6.878600027,6.627708841,0.250891186,2.989786638,-1.568069915,1.421716723
50,4,9,53,77,Washington,Yakima County,256728,256533,256035,-195,-498,894,3441,738,2647,156,794,33,264,-394,-1591,-361,-1327,10,35,3355,3355,3355,13.42651121,10.3283857,3.098125517,1.030107225,-6.207956798,-5.177849573
40,3,5,54,0,West Virginia,West Virginia,1793716,1789798,1782959,-3918,-6839,4383,17232,6995,27102,-2612,-9870,26,556,-1221,2343,-1195,2899,-111,132,43973,43973,43973,9.64633195,15.17147682,-5.525144867,0.31124423,1.31159214,1.62283637
50,3,5,54,1,West Virginia,Barbour County,15465,15440,15468,-25,28,41,173,74,230,-33,-57,0,7,9,76,9,83,-1,2,719,719,719,11.19451275,14.88287822,-3.688365472,0.452957163,4.917820629,5.370777792
50,3,5,54,3,West Virginia,Berkeley County,122076,122654,126069,578,3415,360,1412,339,1313,21,99,4,27,549,3324,553,3351,4,-35,830,830,830,11.35399621,10.55792991,0.796066307,0.217108993,26.72852933,26.94563832
50,3,5,54,5,West Virginia,Boone County,21809,21714,21312,-95,-402,51,195,104,360,-53,-165,0,-1,-42,-233,-42,-234,0,-3,119,119,119,9.06428671,16.73406777,-7.669781063,-0.046483522,-10.83066053,-10.87714405
50,3,5,54,7,West Virginia,Braxton County,12447,12386,12247,-61,-139,23,107,55,217,-32,-110,0,3,-27,-33,-27,-30,-2,1,273,273,273,8.687532984,17.61864166,-8.931108675,0.243575691,-2.679332603,-2.435756911
50,3,5,54,9,West Virginia,Brooke County,22559,22469,22140,-90,-329,50,159,111,373,-61,-214,0,6,-27,-122,-27,-116,-2,1,669,669,669,7.128606335,16.72308279,-9.594476451,0.269004013,-5.469748257,-5.200744244
50,3,5,54,11,West Virginia,Cabell County,94350,94137,93418,-213,-719,242,994,401,1412,-159,-418,2,29,-51,-344,-49,-315,-5,14,3826,3826,3826,10.59955746,15.05691664,-4.457359175,0.309242622,-3.668257311,-3.359014689
50,3,5,54,13,West Virginia,Calhoun County,6229,6199,6176,-30,-23,19,51,30,86,-11,-35,0,0,-18,13,-18,13,-1,-1,9,9,9,8.242424242,13.8989899,-5.656565657,0,2.101010101,2.101010101
50,3,5,54,15,West Virginia,Clay County,8051,8006,7892,-45,-114,18,82,30,140,-12,-58,0,0,-33,-56,-33,-56,0,0,37,37,37,10.31576299,17.61227827,-7.296515285,0,-7.04491131,-7.04491131
50,3,5,54,17,West Virginia,Doddridge County,7808,7786,7735,-22,-51,9,62,20,98,-11,-36,0,1,-10,-16,-10,-15,-1,0,965,965,965,7.989175955,12.62805232,-4.638876361,0.128857677,-2.061722827,-1.93286515
50,3,5,54,19,West Virginia,Fayette County,40488,40358,39927,-130,-431,97,404,188,791,-91,-387,0,7,-35,-57,-35,-50,-4,6,1618,1618,1618,10.06414648,19.70480164,-9.640655166,0.174378776,-1.419941459,-1.245562683
50,3,5,54,21,West Virginia,Gilmer County,7408,7378,7377,-30,-1,15,55,31,87,-16,-32,0,3,-14,28,-14,31,0,0,1595,1595,1595,7.455099966,11.79261267,-4.337512708,0.406641816,3.795323619,4.201965435
50,3,5,54,23,West Virginia,Grant County,10976,10954,10983,-22,29,31,117,65,166,-34,-49,0,0,14,77,14,77,-2,1,81,81,81,10.66690979,15.13424807,-4.467338287,0,7.020103022,7.020103022
50,3,5,54,25,West Virginia,Greenbrier County,32977,32866,32608,-111,-258,92,326,173,634,-81,-308,0,9,-26,37,-26,46,-4,4,463,463,463,9.958151327,19.36646608,-9.408314751,0.274918288,1.130219629,1.405137917
50,3,5,54,27,West Virginia,Hampshire County,23093,23067,23302,-26,235,60,220,95,357,-35,-137,0,0,11,375,11,375,-2,-3,357,357,357,9.48909832,15.39821864,-5.909120317,0,16.17459941,16.17459941
50,3,5,54,29,West Virginia,Hancock County,29095,29019,28656,-76,-363,77,235,139,479,-62,-244,0,1,-11,-123,-11,-122,-3,3,195,195,195,8.1491114,16.61031643,-8.461205028,0.03467707,-4.265279584,-4.230602514
50,3,5,54,31,West Virginia,Hardy County,14299,14240,14160,-59,-80,34,134,38,189,-4,-55,1,12,-55,-36,-54,-24,-1,-1,50,50,50,9.436619718,13.30985916,-3.873239437,0.845070423,-2.535211268,-1.690140845
50,3,5,54,33,West Virginia,Harrison County,65921,65771,65158,-150,-613,181,670,267,1075,-86,-405,0,4,-61,-222,-61,-218,-3,10,752,752,752,10.23455461,16.42111373,-6.186559127,0.061101819,-3.391150929,-3.330049111
50,3,5,54,35,West Virginia,Jackson County,27791,27735,27738,-56,3,73,276,94,416,-21,-140,0,15,-32,126,-32,141,-3,2,135,135,135,9.950786869,14.99828746,-5.047500586,0.540803634,4.542750527,5.083554162
50,3,5,54,37,West Virginia,Jefferson County,57701,57732,58370,31,638,138,532,140,619,-2,-87,0,32,33,693,33,725,0,0,1012,1012,1012,9.164355481,10.66303767,-1.498682193,0.551239427,11.93777885,12.48901828
50,3,5,54,39,West Virginia,Kanawha County,180745,180048,177952,-697,-2096,415,1675,740,2924,-325,-1249,4,86,-364,-950,-360,-864,-12,17,3239,3239,3239,9.357541899,16.33519553,-6.977653631,0.480446927,-5.30726257,-4.826815642
50,3,5,54,41,West Virginia,Lewis County,17033,17009,16892,-24,-117,44,161,68,260,-24,-99,0,0,1,-20,1,-20,-1,2,245,245,245,9.49824489,15.33878057,-5.840535677,0,-1.179906197,-1.179906197
50,3,5,54,43,West Virginia,Lincoln County,20463,20337,20126,-126,-211,49,205,98,373,-49,-168,0,4,-76,-49,-76,-45,-1,2,44,44,44,10.13271384,18.4365964,-8.303882559,0.19771149,-2.421965746,-2.224254257
50,3,5,54,45,West Virginia,Logan County,32567,32473,31909,-94,-564,92,339,160,619,-68,-280,-1,0,-24,-284,-25,-284,-1,0,653,653,653,10.53089373,19.22897704,-8.698083315,0,-8.822341648,-8.822341648
50,3,5,54,47,West Virginia,McDowell County,19111,18916,18363,-195,-553,45,156,97,365,-52,-209,1,3,-144,-343,-143,-340,0,-4,139,139,139,8.369323212,19.58207034,-11.21274712,0.160948523,-18.40178116,-18.24083264
50,3,5,54,49,West Virginia,Marion County,56205,56157,56001,-48,-156,155,575,208,800,-53,-225,0,9,8,50,8,59,-3,10,1331,1331,1331,10.25339254,14.26558962,-4.012197079,0.160487883,0.891599351,1.052087234
50,3,5,54,51,West Virginia,Marshall County,30591,30444,30115,-147,-329,67,260,132,471,-65,-211,0,4,-79,-125,-79,-121,-3,3,511,511,511,8.586667547,15.55507852,-6.968410971,0.132102578,-4.128205552,-3.996102974
50,3,5,54,53,West Virginia,Mason County,25453,25356,25157,-97,-199,58,215,126,441,-68,-226,0,1,-27,23,-27,24,-2,3,572,572,572,8.512660107,17.46085166,-8.948191555,0.039593768,0.910656663,0.950250431
50,3,5,54,55,West Virginia,Mercer County,59664,59462,59097,-202,-365,130,550,260,1058,-130,-508,0,14,-67,121,-67,135,-5,8,1078,1078,1078,9.278080956,17.84765391,-8.569572955,0.236169333,2.04117781,2.277347144
50,3,5,54,57,West Virginia,Mineral County,26938,26877,26857,-61,-20,50,257,96,421,-46,-164,0,1,-12,140,-12,141,-3,3,493,493,493,9.565638143,15.66978077,-6.104142629,0.037220382,5.210853463,5.248073845
50,3,5,54,59,West Virginia,Mingo County,23568,23455,23005,-113,-450,66,259,103,448,-37,-189,0,0,-75,-259,-75,-259,-1,-2,69,69,69,11.14937581,19.2854068,-8.136030994,0,-11.14937581,-11.14937581
50,3,5,54,61,West Virginia,Monongalia County,105822,105916,106387,94,471,289,1002,196,888,93,114,11,212,-12,120,-1,332,2,25,6237,6237,6237,9.439339058,8.365402279,1.073936779,1.997145589,1.130459767,3.127605357
50,3,5,54,63,West Virginia,Monroe County,12376,12330,12332,-46,2,23,97,61,192,-38,-95,0,2,-6,94,-6,96,-2,1,28,28,28,7.866353094,15.57051334,-7.704160247,0.162192847,7.623063823,7.78525667
50,3,5,54,65,West Virginia,Morgan County,17063,17037,17221,-26,184,31,138,83,264,-52,-126,0,0,28,313,28,313,-2,-3,75,75,75,8.056512348,15.4124584,-7.355946056,0,18.27310409,18.27310409
50,3,5,54,67,West Virginia,Nicholas County,24604,24523,24300,-81,-223,42,198,99,414,-57,-216,0,0,-21,-10,-21,-10,-3,3,133,133,133,8.110931323,16.95922004,-8.848288716,0,-0.409642996,-0.409642996
50,3,5,54,69,West Virginia,Ohio County,42425,42264,41776,-161,-488,77,358,174,708,-97,-350,0,5,-61,-150,-61,-145,-3,7,2384,2384,2384,8.519752499,16.84911947,-8.329366968,0.118990957,-3.569728701,-3.450737744
50,3,5,54,71,West Virginia,Pendleton County,6143,6134,6142,-9,8,19,82,25,101,-6,-19,0,0,-3,27,-3,27,0,0,58,58,58,13.35940046,16.45487129,-3.095470837,0,4.39882698,4.39882698
50,3,5,54,73,West Virginia,Pleasants County,7653,7649,7601,-4,-48,18,70,31,110,-13,-40,0,0,10,-9,10,-9,-1,1,694,694,694,9.180327869,14.42622951,-5.245901639,0,-1.180327869,-1.180327869
50,3,5,54,75,West Virginia,Pocahontas County,7869,7847,7841,-22,-6,19,65,36,140,-17,-75,0,0,-3,69,-3,69,-2,0,239,239,239,8.286588475,17.84803672,-9.561448241,0,8.796532381,8.796532381
50,3,5,54,77,West Virginia,Preston County,34216,34176,34358,-40,182,100,345,124,414,-24,-69,1,1,-14,246,-13,247,-3,4,1811,1811,1811,10.06799545,12.08159454,-2.01359909,0.029182596,7.178918493,7.208101089
50,3,5,54,79,West Virginia,Putnam County,57440,57399,57260,-41,-139,122,532,176,761,-54,-229,0,4,16,82,16,86,-3,4,217,217,217,9.279690212,13.27414333,-3.994453118,0.069772107,1.430328191,1.500100297
50,3,5,54,81,West Virginia,Raleigh County,74591,74349,73771,-242,-578,194,716,324,1270,-130,-554,1,11,-108,-46,-107,-35,-5,11,3641,3641,3641,9.667836889,17.14825817,-7.48042128,0.14852822,-0.621118012,-0.472589792
50,3,5,54,83,West Virginia,Randolph County,27932,27852,27806,-80,-46,62,291,104,473,-42,-182,0,6,-34,126,-34,132,-4,4,2174,2174,2174,10.45671781,16.99665816,-6.53994035,0.215602429,4.527651012,4.743253441
50,3,5,54,85,West Virginia,Ritchie County,8444,8424,8383,-20,-41,25,83,31,151,-6,-68,0,4,-13,23,-13,27,-1,0,74,74,74,9.876837032,17.96870352,-8.091866484,0.475992146,2.73695484,3.212946986
50,3,5,54,87,West Virginia,Roane County,14028,13977,13898,-51,-79,31,144,56,222,-25,-78,0,5,-24,-7,-24,-2,-2,1,89,89,89,10.33183857,15.92825112,-5.596412556,0.358744395,-0.502242152,-0.143497758
50,3,5,54,89,West Virginia,Summers County,11959,11915,11908,-44,-7,19,100,57,182,-38,-82,0,0,-4,75,-4,75,-2,0,910,910,910,8.39524829,15.27935189,-6.884103597,0,6.296436217,6.296436217
50,3,5,54,91,West Virginia,Taylor County,16705,16701,16492,-4,-209,37,120,59,235,-22,-115,0,1,18,-95,18,-94,0,0,464,464,464,7.230440153,14.15961197,-6.929171813,0.060253668,-5.724098454,-5.663844787
50,3,5,54,93,West Virginia,Tucker County,6762,6752,6672,-10,-80,13,52,23,137,-10,-85,0,1,2,2,2,3,-2,2,153,153,153,7.747318236,20.41120381,-12.66388558,0.148986889,0.297973778,0.446960668
50,3,5,54,95,West Virginia,Tyler County,8313,8279,8155,-34,-124,16,61,35,139,-19,-78,0,2,-14,-48,-14,-46,-1,0,39,39,39,7.42363393,16.91614945,-9.492515517,0.243397834,-5.84154801,-5.598150176
50,3,5,54,97,West Virginia,Upshur County,23816,23783,23791,-33,8,53,237,75,328,-22,-91,0,1,-10,96,-10,97,-1,2,1151,1151,1151,9.9634254,13.78904444,-3.825619036,0.04203977,4.035817884,4.077857653
50,3,5,54,99,West Virginia,Wayne County,38982,38830,38498,-152,-332,99,357,183,627,-84,-270,2,14,-66,-81,-64,-67,-4,5,196,196,196,9.233395407,16.21663563,-6.983240223,0.362093938,-2.094972067,-1.73287813
50,3,5,54,101,West Virginia,Webster County,8378,8329,8249,-49,-80,12,73,40,129,-28,-56,0,0,-19,-25,-19,-25,-2,1,52,52,52,8.806852455,15.56279406,-6.755941609,0,-3.016045361,-3.016045361
50,3,5,54,103,West Virginia,Wetzel County,14442,14382,14170,-60,-212,37,168,61,290,-24,-122,0,1,-35,-93,-35,-92,-1,2,78,78,78,11.76800224,20.31381339,-8.545811152,0.070047632,-6.514429812,-6.44438218
50,3,5,54,105,West Virginia,Wirt County,5194,5183,5063,-11,-120,15,62,9,70,6,-8,0,0,-16,-111,-16,-111,-1,-1,0,0,0,12.10228382,13.66386883,-1.561585009,0,-21.666992,-21.666992
50,3,5,54,107,West Virginia,Wood County,84296,83996,83624,-300,-372,192,805,373,1259,-181,-454,0,8,-114,57,-114,65,-5,17,943,943,943,9.605059062,15.02207374,-5.417014676,0.095454003,0.680109772,0.775563775
50,3,5,54,109,West Virginia,Wyoming County,21382,21326,21051,-56,-275,56,220,78,376,-22,-156,0,1,-33,-123,-33,-122,-1,3,54,54,54,10.38299077,17.74547514,-7.362484367,0.047195413,-5.805035751,-5.757840338
40,2,3,55,0,Wisconsin,Wisconsin,5893718,5892323,5895908,-1395,3585,15629,60404,16194,62985,-565,-2581,105,2268,-799,3307,-694,5575,-136,591,138424,138424,138424,10.24818737,10.68608174,-0.437894371,0.384790559,0.561068069,0.945858628
50,2,3,55,1,Wisconsin,Adams County,20654,20673,20875,19,202,22,133,68,318,-46,-185,0,3,69,388,69,391,-4,-4,1093,1093,1093,6.402233561,15.30759603,-8.905362472,0.144411283,18.67719265,18.82160393
50,2,3,55,3,Wisconsin,Ashland County,16027,15977,16107,-50,130,26,159,58,188,-32,-29,0,1,-18,158,-18,159,0,0,569,569,569,9.911482359,11.719237,-1.807754644,0.062336367,9.849145992,9.911482359
50,2,3,55,5,Wisconsin,Barron County,46711,46643,46719,-68,76,105,463,158,589,-53,-126,1,22,-12,175,-11,197,-4,5,549,549,549,9.918382211,12.61755318,-2.699170969,0.47128382,3.748848568,4.220132388
50,2,3,55,7,Wisconsin,Bayfield County,16220,16229,16320,9,91,29,105,54,230,-25,-125,0,2,36,216,36,218,-2,-2,111,111,111,6.451811116,14.13253863,-7.680727519,0.12289164,13.27229715,13.39518879
50,2,3,55,9,Wisconsin,Brown County,268740,268741,269591,1,850,730,2965,640,2397,90,568,3,56,-95,160,-92,216,3,66,6335,6335,6335,11.01550716,8.905285214,2.110221945,0.208050051,0.594428717,0.802478768
50,2,3,55,11,Wisconsin,Buffalo County,13317,13320,13302,3,-18,28,119,30,150,-2,-31,0,1,5,10,5,11,0,2,78,78,78,8.939974457,11.26887537,-2.328900909,0.075125836,0.751258358,0.826384194
50,2,3,55,13,Wisconsin,Burnett County,16526,16588,16744,62,156,37,92,36,208,1,-116,0,0,64,276,64,276,-3,-4,133,133,133,5.520220809,12.48049922,-6.960278411,0,16.56066243,16.56066243
50,2,3,55,15,Wisconsin,Calumet County,52442,52476,52539,34,63,135,472,93,453,42,19,0,6,-8,27,-8,33,0,11,152,152,152,8.98919202,8.627338952,0.361853069,0.11426939,0.514212255,0.628481646
50,2,3,55,17,Wisconsin,Chippewa County,66297,66279,66865,-18,586,154,644,161,702,-7,-58,0,2,-8,639,-8,641,-3,3,2713,2713,2713,9.673736706,10.54497386,-0.871237157,0.030042661,9.598630055,9.628672715
50,2,3,55,19,Wisconsin,Clark County,34659,34628,34746,-31,118,144,555,97,386,47,169,0,4,-78,-62,-78,-58,0,7,383,383,383,16.00023063,11.12808833,4.872142301,0.115316978,-1.787413152,-1.672096174
50,2,3,55,21,Wisconsin,Columbia County,58490,58510,58488,20,-22,158,544,161,629,-3,-85,0,12,25,39,25,51,-2,12,1309,1309,1309,9.299304262,10.75232055,-1.453016291,0.205131712,0.666678063,0.871809775
50,2,3,55,23,Wisconsin,Crawford County,16113,16086,16075,-27,-11,53,145,63,193,-10,-48,0,0,-15,35,-15,35,-2,2,717,717,717,9.017132552,12.00211436,-2.98498181,0,2.176549237,2.176549237
50,2,3,55,25,Wisconsin,Dane County,561504,562306,563951,802,1645,1508,5532,1043,4186,465,1346,34,666,290,-492,324,174,13,125,13510,13510,13510,9.82369033,7.433472112,2.390218218,1.182678554,-0.873690463,0.308988091
50,2,3,55,27,Wisconsin,Dodge County,89396,89262,89313,-134,51,207,734,315,1141,-108,-407,0,12,-24,435,-24,447,-2,11,6323,6323,6323,8.220635587,12.77894442,-4.558308834,0.134397312,4.871902562,5.006299874
50,2,3,55,29,Wisconsin,Door County,30066,30102,30369,36,267,63,188,103,420,-40,-232,0,3,82,502,82,505,-6,-6,335,335,335,6.217856493,13.890956,-7.673099502,0.099221114,16.60299979,16.7022209
50,2,3,55,31,Wisconsin,Douglas County,44295,44275,44203,-20,-72,92,398,171,519,-79,-121,0,13,61,28,61,41,-2,8,1259,1259,1259,8.996586722,11.73172992,-2.735143199,0.29385836,0.632925699,0.926784059
50,2,3,55,33,Wisconsin,Dunn County,45440,45440,45547,0,107,119,407,90,358,29,49,0,17,-28,30,-28,47,-1,11,3205,3205,3205,8.946332993,7.869256048,1.077076945,0.373679756,0.659434864,1.033114621
50,2,3,55,35,Wisconsin,Eau Claire County,105710,105818,106452,108,634,282,1099,233,1008,49,91,1,48,58,477,59,525,0,18,4540,4540,4540,10.35473689,9.497338296,0.857398596,0.452254205,4.494276158,4.946530362
50,2,3,55,37,Wisconsin,Florence County,4558,4556,4593,-2,37,3,28,13,72,-10,-44,0,0,8,83,8,83,0,-2,51,51,51,6.120887529,15.73942507,-9.618537545,0,18.14405946,18.14405946
50,2,3,55,39,Wisconsin,Fond du Lac County,104154,104076,104362,-78,286,245,995,310,1146,-65,-151,2,32,-10,392,-8,424,-5,13,3231,3231,3231,9.547203485,10.99607557,-1.448872087,0.30704574,3.761310318,4.068356058
50,2,3,55,41,Wisconsin,Forest County,9179,9160,9258,-19,98,28,100,35,117,-7,-17,0,1,-12,117,-12,118,0,-3,301,301,301,10.85894234,12.70496254,-1.846020198,0.108589423,12.70496254,12.81355196
50,2,3,55,43,Wisconsin,Grant County,51938,51934,52110,-4,176,152,562,148,571,4,-9,0,2,-6,174,-6,176,-2,9,4023,4023,4023,10.80312176,10.97612549,-0.173003729,0.038445273,3.344738764,3.383184038
50,2,3,55,45,Wisconsin,Green County,37093,36992,36988,-101,-4,84,325,125,431,-41,-106,0,4,-59,93,-59,97,-1,5,297,297,297,8.786158421,11.65179778,-2.865639362,0.108137334,2.514193025,2.62233036
50,2,3,55,47,Wisconsin,Green Lake County,19018,18997,19229,-21,232,44,184,74,255,-30,-71,0,3,11,302,11,305,-2,-2,143,143,143,9.626955475,13.3417046,-3.714749124,0.156961231,15.80076388,15.95772511
50,2,3,55,49,Wisconsin,Iowa County,23709,23676,23756,-33,80,52,227,73,214,-21,13,0,2,-11,61,-11,63,-1,4,134,134,134,9.571597234,9.023444088,0.548153146,0.084331253,2.572103222,2.656434475
50,2,3,55,51,Wisconsin,Iron County,6137,6128,6178,-9,50,5,43,32,106,-27,-63,0,0,20,114,20,114,-2,-1,87,87,87,6.988460913,17.22736876,-10.23890785,0,18.52754754,18.52754754
50,2,3,55,53,Wisconsin,Jackson County,21145,21102,21121,-43,19,53,248,68,256,-15,-8,0,1,-27,21,-27,22,-1,5,1281,1281,1281,11.74715203,12.12609241,-0.378940388,0.047367549,0.994718518,1.042086067
50,2,3,55,55,Wisconsin,Jefferson County,84900,84858,84943,-42,85,203,777,225,902,-22,-125,0,13,-17,182,-17,195,-3,15,3071,3071,3071,9.151889565,10.62420127,-1.472311706,0.153120417,2.143685844,2.296806261
50,2,3,55,57,Wisconsin,Juneau County,26718,26759,26802,41,43,53,229,79,319,-26,-90,0,1,68,131,68,132,-1,1,1569,1569,1569,8.550997928,11.91165214,-3.360654207,0.037340602,4.891618902,4.928959504
50,2,3,55,59,Wisconsin,Kenosha County,169151,169073,168732,-78,-341,458,1711,472,1700,-14,11,1,2,-67,-389,-66,-387,2,35,4020,4020,4020,10.13010465,10.06497832,0.06512633,0.011841151,-2.303103862,-2.291262711
50,2,3,55,61,Wisconsin,Kewaunee County,20563,20539,20543,-24,4,46,193,53,257,-7,-64,0,7,-16,59,-16,66,-1,2,125,125,125,9.395842461,12.51156224,-3.11571978,0.340781851,2.872304172,3.213086023
50,2,3,55,63,Wisconsin,La Crosse County,120784,120852,120433,68,-419,326,1072,315,1177,11,-105,0,17,59,-350,59,-333,-2,19,5405,5405,5405,8.885757507,9.756097561,-0.870340054,0.140912199,-2.901133514,-2.760221315
50,2,3,55,65,Wisconsin,Lafayette County,16611,16605,16784,-6,179,53,224,37,167,16,57,0,0,-21,121,-21,121,-1,1,67,67,67,13.41759262,10.0032945,3.414298122,0,7.247896014,7.247896014
50,2,3,55,67,Wisconsin,Langlade County,19491,19438,19502,-53,64,41,199,85,286,-44,-87,0,6,-6,144,-6,150,-3,1,242,242,242,10.22085259,14.68926554,-4.468412943,0.30816641,7.395993837,7.704160247
50,2,3,55,69,Wisconsin,Lincoln County,28415,28374,28541,-41,167,51,248,101,416,-50,-168,0,1,12,335,12,336,-3,-1,565,565,565,8.714750066,14.61829043,-5.903540367,0.035140121,11.77194061,11.80708073
50,2,3,55,71,Wisconsin,Manitowoc County,81359,81250,81505,-109,255,173,744,299,987,-126,-243,0,24,23,470,23,494,-6,4,940,940,940,9.142576265,12.12865964,-2.986083377,0.294921815,5.77555221,6.070474025
50,2,3,55,73,Wisconsin,Marathon County,138013,137954,137648,-59,-306,371,1422,342,1473,29,-51,1,10,-84,-289,-83,-279,-5,24,1343,1343,1343,10.31922845,10.68932736,-0.370098911,0.072568414,-2.097227161,-2.024658747
50,2,3,55,75,Wisconsin,Marinette County,41872,41869,41875,-3,6,95,361,156,597,-61,-236,2,5,60,235,62,240,-4,2,562,562,562,8.621513183,14.25773787,-5.636224685,0.11941154,5.612342377,5.731753917
50,2,3,55,77,Wisconsin,Marquette County,15592,15584,15792,-8,208,28,143,55,234,-27,-91,0,1,21,301,21,302,-2,-3,96,96,96,9.115247323,14.91585926,-5.800611933,0.063742988,19.18663947,19.25038246
50,2,3,55,78,Wisconsin,Menominee County,4255,4255,4289,0,34,23,82,18,81,5,1,0,0,-4,32,-4,32,-1,1,23,23,23,19.19475655,18.96067416,0.234082397,0,7.490636704,7.490636704
50,2,3,55,79,Wisconsin,Milwaukee County,939489,938149,928059,-1340,-10090,3052,12364,2647,10375,405,1989,60,722,-1830,-12764,-1770,-12042,25,-37,21586,21586,21586,13.25039867,11.11880348,2.131595192,0.773761553,-13.67907543,-12.90531388
50,2,3,55,81,Wisconsin,Monroe County,46274,46281,46193,7,-88,155,527,116,509,39,18,0,12,-32,-124,-32,-112,0,6,1026,1026,1026,11.3977983,11.00849969,0.389298614,0.259532409,-2.681834894,-2.422302485
50,2,3,55,83,Wisconsin,Oconto County,38965,39043,39356,78,313,89,359,100,477,-11,-118,0,-1,91,434,91,433,-2,-2,219,219,219,9.15828008,12.16852256,-3.010242478,-0.025510529,11.07156979,11.04605926
50,2,3,55,85,Wisconsin,Oneida County,37845,37839,38259,-6,420,70,271,151,577,-81,-306,0,2,82,731,82,733,-7,-7,592,592,592,7.122394807,15.1646561,-8.042261295,0.052563799,19.21206865,19.26463245
50,2,3,55,87,Wisconsin,Outagamie County,190705,190832,191545,127,713,550,2060,443,1754,107,306,0,45,18,327,18,372,2,35,2781,2781,2781,10.77470664,9.174191962,1.600514675,0.235369805,1.710353918,1.945723723
50,2,3,55,89,Wisconsin,Ozaukee County,91503,91569,92497,66,928,237,779,267,975,-30,-196,-1,38,105,1091,104,1129,-8,-5,1890,1890,1890,8.464355177,10.59402606,-2.129670879,0.412895375,11.85444352,12.26733889
50,2,3,55,91,Wisconsin,Pepin County,7318,7335,7364,17,29,25,78,22,79,3,-1,0,2,15,28,15,30,-1,0,50,50,50,10.61296687,10.74903055,-0.136063678,0.272127356,3.809782978,4.081910334
50,2,3,55,93,Wisconsin,Pierce County,42212,42191,42587,-21,396,99,337,95,374,4,-37,0,10,-25,421,-25,431,0,2,2633,2633,2633,7.950175753,8.823043714,-0.872867961,0.23591026,9.931821935,10.1677322
50,2,3,55,95,Wisconsin,Polk County,44977,45006,45431,29,425,99,366,114,538,-15,-172,0,3,49,598,49,601,-5,-4,351,351,351,8.09403231,11.8977852,-3.803752889,0.066344527,13.22467574,13.29102027
50,2,3,55,97,Wisconsin,Portage County,70377,70378,70468,1,90,158,600,152,620,6,-20,-1,43,-3,56,-4,99,-1,11,2923,2923,2923,8.519943768,8.803941894,-0.283998126,0.61059597,0.795194752,1.405790722
50,2,3,55,99,Wisconsin,Price County,14054,14015,14050,-39,35,14,100,44,206,-30,-106,0,4,-7,138,-7,142,-2,-1,153,153,153,7.126313914,14.68020666,-7.553892749,0.285052557,9.834313202,10.11936576
50,2,3,55,101,Wisconsin,Racine County,197727,197440,196896,-287,-544,511,2175,588,2231,-77,-56,-1,48,-207,-571,-208,-523,-2,35,4817,4817,4817,11.03120182,11.31522357,-0.284021748,0.243447213,-2.896007466,-2.652560253
50,2,3,55,103,Wisconsin,Richland County,17304,17274,17212,-30,-62,35,156,50,216,-15,-60,0,7,-13,-11,-13,-4,-2,2,249,249,249,9.047149568,12.52682248,-3.479672911,0.40596184,-0.637940034,-0.231978194
50,2,3,55,105,Wisconsin,Rock County,163687,163643,164381,-44,738,464,1817,468,1866,-4,-49,0,12,-36,752,-36,764,-4,23,2384,2384,2384,11.07845767,11.3772163,-0.298758627,0.073165378,4.585030364,4.658195742
50,2,3,55,107,Wisconsin,Rusk County,14188,14168,14123,-20,-45,39,121,51,188,-12,-67,0,1,-7,21,-7,22,-1,0,130,130,130,8.553957089,13.29044573,-4.736488636,0.07069386,1.484571065,1.555264925
50,2,3,55,109,Wisconsin,St. Croix County,93536,93797,95044,261,1247,254,923,203,777,51,146,0,1,208,1100,208,1101,2,0,698,698,698,9.775419533,8.229145154,1.546274379,0.01059092,11.65001244,11.66060337
50,2,3,55,111,Wisconsin,Sauk County,65763,65718,65697,-45,-21,183,688,201,718,-18,-30,0,21,-24,-26,-24,-5,-3,14,669,669,669,10.47064643,10.92721531,-0.456568885,0.319598219,-0.395693034,-0.076094814
50,2,3,55,113,Wisconsin,Sawyer County,18074,18107,18295,33,188,41,131,72,257,-31,-126,0,1,67,316,67,317,-3,-3,312,312,312,7.197406736,14.12010329,-6.922696555,0.054942036,17.36168342,17.41662546
50,2,3,55,115,Wisconsin,Shawano County,40881,40838,40859,-43,21,98,410,140,533,-42,-123,0,2,2,139,2,141,-3,3,587,587,587,10.03708827,13.04821475,-3.01112648,0.048961406,3.402817729,3.451779135
50,2,3,55,117,Wisconsin,Sheboygan County,118034,117937,117747,-97,-190,292,1158,349,1353,-57,-195,0,26,-35,-43,-35,-17,-5,22,2769,2769,2769,9.82671713,11.4814752,-1.654758066,0.220634409,-0.364895368,-0.14426096
50,2,3,55,119,Wisconsin,Taylor County,19913,19897,19923,-16,26,55,218,62,209,-7,9,0,1,-7,13,-7,14,-2,3,125,125,125,10.94927172,10.49723757,0.452034154,0.050226017,0.652938222,0.703164239
50,2,3,55,121,Wisconsin,Trempealeau County,30760,30776,30724,16,-52,95,414,68,324,27,90,0,6,-9,-152,-9,-146,-2,4,426,426,426,13.46341463,10.53658537,2.926829268,0.195121951,-4.943089431,-4.74796748
50,2,3,55,123,Wisconsin,Vernon County,30714,30693,30915,-21,222,114,411,106,365,8,46,0,1,-28,173,-28,174,-1,2,246,246,246,13.34242306,11.84911051,1.493312557,0.032463317,5.616153746,5.648617063
50,2,3,55,125,Wisconsin,Vilas County,23047,23076,23520,29,444,35,163,90,353,-55,-190,0,2,88,645,88,647,-4,-13,217,217,217,6.996308696,15.15151515,-8.155206455,0.085844279,27.68477981,27.77062409
50,2,3,55,127,Wisconsin,Walworth County,106478,106499,106799,21,300,235,860,282,1242,-47,-382,0,-3,73,672,73,669,-5,13,3021,3021,3021,8.063835573,11.64567882,-3.581843243,-0.028129659,6.30104361,6.272913951
50,2,3,55,129,Wisconsin,Washburn County,16623,16597,16752,-26,155,29,117,69,259,-40,-142,0,2,16,301,16,303,-2,-6,197,197,197,7.01670215,15.53269963,-8.515997481,0.119943627,18.05151579,18.17145941
50,2,3,55,131,Wisconsin,Washington County,136761,136732,137175,-29,443,321,1178,368,1439,-47,-261,0,14,23,673,23,687,-5,17,872,872,872,8.60145962,10.50721595,-1.905756333,0.102224478,4.914076676,5.016301153
50,2,3,55,133,Wisconsin,Waukesha County,406978,407148,408756,170,1608,1001,3627,1136,4438,-135,-811,5,164,323,2220,328,2384,-23,35,5160,5160,5160,8.890751853,10.87873083,-1.987978978,0.402008079,5.441816684,5.843824764
50,2,3,55,135,Wisconsin,Waupaca County,51812,51713,51570,-99,-143,111,485,228,821,-117,-336,0,0,22,187,22,187,-4,6,1321,1321,1321,9.391671427,15.89806648,-6.50639505,0,3.621118674,3.621118674
50,2,3,55,137,Wisconsin,Waushara County,24520,24511,24828,-9,317,52,197,76,331,-24,-134,0,3,17,455,17,458,-2,-7,1149,1149,1149,7.985569225,13.41737773,-5.431808508,0.121607653,18.4438274,18.56543505
50,2,3,55,139,Wisconsin,Winnebago County,171730,171646,171623,-84,-23,472,1662,510,1801,-38,-139,-2,73,-42,6,-44,79,-2,37,7315,7315,7315,9.683367854,10.49322834,-0.809860488,0.425322415,0.034958007,0.460280422
50,2,3,55,141,Wisconsin,Wood County,74207,74091,74070,-116,-21,165,781,237,941,-72,-160,0,6,-39,121,-39,127,-5,12,666,666,666,10.54258543,12.70239807,-2.159812636,0.080992974,1.633358306,1.71435128
40,4,8,56,0,Wyoming,Wyoming,576851,577267,578803,416,1536,1643,6213,1500,6042,143,171,4,116,279,1252,283,1368,-10,-3,12894,12894,12894,10.74848409,10.45265425,0.295829837,0.20067989,2.165958809,2.366638698
50,4,8,56,1,Wyoming,Albany County,37066,37079,37608,13,529,80,351,58,256,22,95,0,33,-10,398,-10,431,1,3,2042,2042,2042,9.399226104,6.855276019,2.543950085,0.883687924,10.65781194,11.54149986
50,4,8,56,3,Wyoming,Big Horn County,11521,11467,11632,-54,165,28,96,48,134,-20,-38,0,-2,-34,207,-34,205,0,-2,140,140,140,8.312048141,11.60223386,-3.290185722,-0.17316767,17.9228538,17.74968613
50,4,8,56,5,Wyoming,Campbell County,47026,47116,46401,90,-715,164,583,86,385,78,198,-2,-1,11,-906,9,-907,3,-6,467,467,467,12.46832127,8.233797064,4.234524204,-0.021386486,-19.37615621,-19.39754269
50,4,8,56,7,Wyoming,Carbon County,14537,14499,14649,-38,150,44,151,44,178,0,-27,0,8,-38,171,-38,179,0,-2,685,685,685,10.3609167,12.21353095,-1.852614245,0.548922739,11.73322355,12.28214629
50,4,8,56,9,Wyoming,Converse County,13751,13724,13672,-27,-52,35,155,36,137,-1,18,-1,-1,-25,-70,-26,-71,0,1,68,68,68,11.31552051,10.00146007,1.314060447,-0.073003358,-5.110235071,-5.183238429
50,4,8,56,11,Wyoming,Crook County,7181,7178,7315,-3,137,32,106,31,92,1,14,0,11,-3,112,-3,123,-1,0,18,18,18,14.62775133,12.69578417,1.931967157,1.517974194,15.45573725,16.97371145
50,4,8,56,13,Wyoming,Fremont County,39234,39177,39336,-57,159,120,457,146,567,-26,-110,0,-1,-30,267,-30,266,-1,3,969,969,969,11.64138423,14.44346796,-2.802083731,-0.025473488,6.801421421,6.775947932
50,4,8,56,15,Wyoming,Goshen County,12498,12503,12537,5,34,33,118,37,200,-4,-82,0,0,12,115,12,115,-3,1,1068,1068,1068,9.424920128,15.9744409,-6.549520767,0,9.185303514,9.185303514
50,4,8,56,17,Wyoming,Hot Springs County,4621,4622,4597,1,-25,9,39,20,82,-11,-43,0,1,14,16,14,17,-2,1,83,83,83,8.460787504,17.78934809,-9.328560581,0.216943269,3.471092309,3.688035579
50,4,8,56,19,Wyoming,Johnson County,8447,8459,8623,12,164,25,69,25,96,0,-27,0,1,13,192,13,193,-1,-2,42,42,42,8.078679312,11.23990165,-3.161222339,0.117082309,22.4798033,22.59688561
50,4,8,56,21,Wyoming,Laramie County,100512,100690,100863,178,173,322,1125,263,996,59,129,2,11,118,15,120,26,-1,18,1956,1956,1956,11.16331685,9.883256513,1.280060332,0.109152431,0.148844225,0.257996656
50,4,8,56,23,Wyoming,Lincoln County,19581,19674,20153,93,479,60,222,26,186,34,36,0,-4,60,451,60,447,-1,-4,36,36,36,11.14821603,9.340397218,1.807818816,-0.200868757,22.64795239,22.44708364
50,4,8,56,25,Wyoming,Natrona County,79955,80229,79555,274,-674,251,901,213,930,38,-29,1,5,235,-655,236,-650,0,5,1503,1503,1503,11.27772493,11.64071497,-0.362990037,0.062584489,-8.198568067,-8.135983578
50,4,8,56,27,Wyoming,Niobrara County,2467,2439,2438,-28,-1,4,28,12,26,-8,2,0,0,-20,-2,-20,-2,0,-1,252,252,252,11.48246873,10.66229239,0.820176338,0,-0.820176338,-0.820176338
50,4,8,56,29,Wyoming,Park County,29624,29656,30108,32,452,76,276,85,348,-9,-72,-1,2,46,528,45,530,-4,-6,500,500,500,9.236329563,11.64580684,-2.409477277,0.066929924,17.66950003,17.73642996
50,4,8,56,31,Wyoming,Platte County,8605,8623,8699,18,76,14,89,28,104,-14,-15,0,0,34,91,34,91,-2,0,83,83,83,10.27594966,12.00785129,-1.731901628,0,10.50686988,10.50686988
50,4,8,56,33,Wyoming,Sheridan County,30921,30996,31646,75,650,87,307,83,377,4,-70,2,20,70,709,72,729,-1,-9,992,992,992,9.801730468,12.03665273,-2.234922257,0.638549216,22.63656971,23.27511893
50,4,8,56,35,Wyoming,Sublette County,8728,8723,8697,-5,-26,19,85,19,81,0,4,0,4,-4,-34,-4,-30,-1,0,449,449,449,9.758897819,9.299655568,0.45924225,0.45924225,-3.903559127,-3.444316877
50,4,8,56,37,Wyoming,Sweetwater County,42272,42158,41614,-114,-544,112,481,116,400,-4,81,1,18,-113,-639,-112,-621,2,-4,720,720,720,11.48355059,9.54973022,1.93382037,0.42973786,-15.25569403,-14.82595617
50,4,8,56,39,Wyoming,Teton County,23331,23347,23575,16,228,44,220,29,96,15,124,2,8,-2,95,0,103,1,1,215,215,215,9.377264396,4.091897191,5.285367205,0.340991433,4.049273262,4.390264695
50,4,8,56,41,Wyoming,Uinta County,20450,20441,20635,-9,194,50,226,49,166,1,60,0,3,-11,131,-11,134,1,0,187,187,187,11.0039926,8.082578635,2.921413964,0.146070698,6.378420489,6.524491187
50,4,8,56,43,Wyoming,Washakie County,7685,7658,7705,-27,47,18,76,32,115,-14,-39,0,0,-13,87,-13,87,0,-1,119,119,119,9.893900931,14.9710343,-5.077133372,0,11.32591291,11.32591291
50,4,8,56,45,Wyoming,Weston County,6838,6809,6745,-29,-64,16,52,14,90,2,-38,0,0,-31,-27,-31,-27,0,1,300,300,300,7.673011657,13.28021248,-5.607200826,0,-3.984063745,-3.984063745